link_id,AAWDT,mpo_vol_am,mpo_vol_md,mpo_vol_pm,mpo_vol_nt,mpo_vol_total
1,0,641,946,653,304,2544
2,0,147,216,148,64,575
3,0,421,1002,1004,446,2873
4,0,886,1161,818,378,3243
5,0,239,417,310,132,1098
6,0,596,921,740,329,2586
7,0,321,448,338,147,1254
8,0,88,151,126,49,414
9,0,625,844,567,263,2299
10,0,98,172,108,57,435
11,0,326,359,266,106,1057
12,0,802,1033,701,317,2853
13,0,425,910,828,355,2518
14,0,415,609,463,201,1688
15,0,35,120,84,46,285
16,0,383,775,694,300,2152
17,0,24,121,66,51,262
18,0,521,817,728,319,2385
19,0,229,320,255,118,922
20,0,7,63,18,25,113
20,0,232,324,247,97,900
21,0,343,502,365,167,1377
22,0,47,65,52,21,185
23,0,299,391,343,133,1166
24,0,10,92,26,36,164
25,0,261,402,323,149,1135
26,0,196,338,296,127,957
27,0,70,154,101,55,380
27,0,311,454,332,150,1247
28,0,235,544,522,214,1515
29,0,192,583,536,231,1542
30,0,392,779,645,274,2090
31,0,24,66,49,24,163
32,0,260,438,344,146,1188
33,0,627,847,593,261,2328
34,0,301,422,361,156,1240
35,0,160,317,219,100,796
36,0,723,1404,1223,516,3866
37,0,609,1102,900,393,3004
38,0,544,1092,879,397,2912
39,0,622,978,793,329,2722
40,0,192,55,387,19,653
41,0,545,1095,475,371,2486
42,0,500,638,441,193,1772
43,0,346,538,425,191,1500
44,0,523,762,562,246,2093
45,0,38,56,38,16,148
46,0,493,656,453,203,1805
48,0,234,784,627,319,1964
49,0,1228,2199,2023,846,6296
50,0,350,1050,1125,451,2976
51,0,362,1230,1134,493,3219
52,0,1385,2563,2109,948,7005
53,0,1828,2926,2280,1024,8058
54,0,456,990,906,369,2721
55,0,717,1516,1302,606,4141
56,0,179,404,334,144,1061
57,0,248,489,407,207,1351
58,0,304,567,463,177,1511
59,0,502,885,673,296,2356
61,0,487,786,613,290,2176
62,0,1122,1948,1513,727,5310
63,0,262,372,286,118,1038
64,0,908,1281,952,418,3559
66,0,752,1352,1047,500,3651
67,0,35,95,83,37,250
65,0,863,1518,1290,546,4217
68,0,798,1175,827,369,3169
69,0,291,485,376,160,1312
70,0,114,382,405,177,1078
71,0,221,561,644,223,1649
72,0,3,8,8,4,23
73,0,902,1296,976,452,3626
74,0,348,499,368,160,1375
75,0,631,806,560,249,2246
76,0,348,519,370,161,1398
77,0,419,616,460,196,1691
78,0,531,772,578,247,2128
79,0,616,1042,1012,381,3051
80,0,8,13,14,5,40
81,0,796,1584,1488,610,4478
82,0,173,288,273,98,832
83,0,96,277,200,110,683
84,0,954,1565,1463,561,4543
85,0,638,1043,912,401,2994
86,0,475,996,811,377,2659
87,0,556,2129,2649,1159,6493
88,0,62,140,97,50,349
89,0,304,607,622,240,1773
90,0,74,203,184,76,537
91,0,483,831,687,225,2226
92,0,5,14,14,7,40
93,0,416,717,501,311,1945
94,0,914,1450,1226,537,4127
95,0,60,186,109,72,427
95,0,76,181,161,68,486
96,0,781,1537,1236,554,4108
97,0,385,619,552,193,1749
98,0,97,293,138,75,603
99,0,342,438,339,175,1294
100,0,142,341,276,132,891
101,0,452,929,825,338,2544
102,0,992,1464,1111,525,4092
103,0,156,258,212,86,712
105,0,867,1616,1300,597,4380
106,0,472,704,497,242,1915
107,0,231,401,315,126,1073
108,0,368,506,349,151,1374
109,0,1359,1840,1259,572,5030
110,0,438,698,572,253,1961
111,0,301,520,440,186,1447
114,0,14,81,36,32,163
114,0,302,440,424,151,1317
115,0,333,455,359,146,1293
116,0,41,126,117,53,337
117,0,541,955,868,387,2751
118,0,407,611,446,198,1662
119,0,429,591,428,191,1639
120,0,464,599,418,186,1667
121,0,23,49,41,19,132
122,0,543,759,569,248,2119
123,0,406,573,396,177,1552
124,0,376,602,467,212,1657
125,0,438,733,637,257,2065
126,0,373,693,614,285,1965
127,0,218,282,194,86,780
128,0,13,21,14,6,54
129,0,82,267,363,129,841
130,0,165,551,693,282,1691
131,0,264,1000,1264,468,2996
132,0,113,331,390,148,982
133,0,299,806,930,335,2370
134,0,33,100,100,42,275
135,0,58,238,302,110,708
136,0,876,1619,1295,577,4367
137,0,307,568,416,196,1487
138,0,38,179,188,37,442
139,0,153,318,265,159,895
140,0,29,58,53,23,163
141,0,193,396,325,147,1061
142,0,227,662,633,233,1755
143,0,242,612,583,281,1718
144,0,747,1509,1229,595,4080
145,0,562,1157,961,419,3099
146,0,176,411,359,112,1058
147,0,896,1545,1318,632,4391
148,0,970,1477,1047,469,3963
149,0,1113,1715,1263,569,4660
150,0,231,373,312,132,1048
151,0,164,319,277,108,868
152,0,417,709,572,268,1966
153,0,589,948,669,356,2562
154,0,347,754,588,224,1913
155,0,929,1481,1081,501,3992
156,0,322,881,793,346,2342
157,0,193,639,627,261,1720
158,0,864,1575,1206,551,4196
159,0,735,1335,1074,477,3621
160,0,613,1190,1008,448,3259
160,0,143,327,253,102,825
161,0,583,938,712,328,2561
161,0,134,206,177,52,569
162,0,163,368,463,144,1138
163,0,346,965,938,399,2648
164,0,758,1042,757,325,2882
165,0,222,442,286,145,1095
166,0,524,782,450,186,1942
167,0,16,90,169,95,370
168,0,383,648,483,220,1734
170,0,190,595,621,269,1675
171,0,891,1470,1114,496,3971
172,0,594,1215,1011,486,3306
173,0,137,333,279,85,834
174,0,215,360,260,115,950
175,0,781,1444,1146,498,3869
176,0,711,1461,1223,545,3940
176,0,0,0,0,0,0
176,0,245,641,556,250,1692
177,0,96,367,488,170,1121
178,0,83,330,345,177,935
179,0,146,567,744,268,1725
180,0,179,425,391,166,1161
181,0,48,136,126,55,365
183,0,77,169,131,65,442
183,0,306,508,404,175,1393
184,0,363,511,361,160,1395
185,0,35,81,50,29,195
186,0,337,576,433,187,1533
187,0,63,140,116,58,377
188,0,99,181,137,58,475
189,0,245,451,350,167,1213
190,0,84,176,160,53,473
191,0,94,248,224,82,648
192,0,221,406,364,191,1182
193,0,273,552,455,191,1471
194,0,3,6,5,2,16
195,0,320,611,474,214,1619
196,0,106,200,148,85,539
197,0,175,276,229,96,776
198,0,300,564,420,192,1476
199,0,212,327,242,104,885
200,0,224,565,530,259,1578
201,0,290,867,817,342,2316
202,0,298,782,746,301,2127
203,0,190,494,456,218,1358
205,0,75,140,136,66,417
204,0,195,551,509,198,1453
207,0,139,239,174,86,638
207,0,207,473,375,172,1227
208,0,70,136,124,42,372
209,0,42,78,65,22,207
210,0,243,543,398,69,1253
210,0,71,74,62,140,347
211,0,279,575,525,210,1589
212,0,79,154,120,49,402
213,0,178,304,221,107,810
214,0,167,326,237,100,830
215,0,202,340,246,119,907
216,0,0,0,0,0,0
217,0,69,113,92,36,310
219,0,418,820,705,304,2247
218,0,370,760,610,292,2032
222,0,208,505,433,170,1316
222,0,144,259,240,112,755
224,0,56,114,77,23,270
225,0,224,378,269,128,999
225,0,86,142,127,57,412
226,0,475,807,590,284,2156
227,0,81,138,114,38,371
228,0,648,967,713,322,2650
229,0,266,496,336,150,1248
230,0,8,9,7,3,27
231,0,180,428,383,256,1247
232,0,763,2274,2043,849,5929
233,0,335,740,591,197,1863
234,0,496,676,512,280,1964
235,0,194,420,299,145,1058
236,0,147,257,218,97,719
237,0,237,481,369,165,1252
238,0,442,880,728,320,2370
239,0,429,761,650,268,2108
241,0,1126,2134,1595,665,5520
241,0,410,558,433,281,1682
242,0,342,513,360,164,1379
243,0,522,975,837,322,2656
244,0,120,245,189,99,653
244,0,69,195,178,107,549
245,0,1217,2368,2042,880,6507
246,0,20,37,38,15,110
247,0,24,43,39,17,123
248,0,674,1555,1323,632,4184
249,0,548,912,667,296,2423
250,0,244,561,485,194,1484
251,0,521,1050,943,392,2906
252,0,337,686,452,248,1723
253,0,60,132,200,45,437
254,0,461,1368,1355,602,3786
255,0,322,764,650,298,2034
256,0,744,1670,1348,604,4366
257,0,358,555,392,175,1480
258,0,266,387,284,124,1061
259,0,387,573,397,182,1539
260,0,41,169,100,62,372
261,0,589,923,719,304,2535
262,0,555,835,606,275,2271
263,0,363,660,489,225,1737
264,0,375,84,67,193,719
265,0,25,540,408,11,984
266,0,507,1269,1112,468,3356
267,0,13,35,31,13,92
268,0,572,1144,1071,458,3245
269,0,586,2306,2798,1112,6802
270,0,255,926,901,384,2466
271,0,1118,1810,1327,598,4853
272,0,563,1227,901,172,2863
273,0,118,1117,1745,959,3939
274,0,770,860,939,670,3239
275,0,360,927,589,165,2041
275,0,0,389,296,0,685
276,0,720,1772,1537,675,4704
277,0,43,133,125,56,357
278,0,978,2530,2232,991,6731
279,0,979,2580,2105,1004,6668
280,0,57,182,181,75,495
281,0,146,462,492,196,1296
282,0,93,145,95,45,378
283,0,524,696,485,215,1920
284,0,2,4,3,2,11
285,0,185,240,184,81,690
286,0,132,279,159,93,663
287,0,339,499,359,166,1363
288,0,404,702,541,238,1885
289,0,442,974,825,319,2560
290,0,333,580,488,256,1657
292,0,309,636,499,223,1667
291,0,348,612,533,222,1715
293,0,120,308,228,108,764
294,0,131,265,228,106,730
295,0,224,431,358,149,1162
297,0,322,850,820,325,2317
298,0,452,965,899,468,2784
299,0,392,1275,1493,547,3707
300,0,9,319,398,14,740
301,0,615,1344,995,634,3588
302,0,250,885,924,389,2448
303,0,312,969,1151,523,2955
304,0,229,528,559,305,1621
305,0,134,406,455,117,1112
306,0,171,499,492,173,1335
307,0,155,344,354,165,1018
308,0,1,19,24,2,46
309,0,778,1504,1320,598,4200
310,0,150,247,169,79,645
311,0,259,401,309,129,1098
312,0,513,669,465,213,1860
313,0,127,548,527,109,1311
314,0,464,957,906,527,2854
315,0,76,140,103,52,371
316,0,367,591,442,198,1598
317,0,490,1221,1160,479,3350
318,0,11,37,38,15,101
319,0,523,1309,1248,526,3606
320,0,388,611,511,209,1719
321,0,228,561,452,224,1465
322,0,239,481,434,176,1330
323,0,336,615,476,214,1641
324,0,354,558,407,183,1502
325,0,299,1089,1220,525,3133
326,0,295,562,432,173,1462
327,0,519,772,596,287,2174
328,0,129,246,160,73,608
329,0,448,623,468,201,1740
330,0,124,179,139,49,491
331,0,498,711,504,232,1945
332,0,10,14,9,4,37
333,0,101,344,493,185,1123
334,0,112,148,166,210,636
335,0,90,366,441,165,1062
336,0,1,341,446,0,788
337,0,1,4,2,1,8
338,0,353,1239,1293,545,3430
339,0,176,657,700,275,1808
340,0,122,406,452,181,1161
341,0,160,594,638,251,1643
343,0,178,663,679,290,1810
344,0,404,1378,1399,584,3765
345,0,82,274,308,120,784
346,0,2,4,3,1,10
347,0,50,157,155,83,445
348,0,46,191,222,70,529
349,0,20,73,84,34,211
350,0,138,554,803,263,1758
351,0,8,24,29,12,73
352,0,28,96,95,41,260
353,0,63,223,264,97,647
354,0,152,463,558,201,1374
355,0,16,87,112,22,237
356,0,133,414,473,208,1228
357,0,77,150,135,66,428
358,0,150,324,281,118,873
359,0,4627,9877,2721,5361,22586
360,0,1385,2043,401,1118,4947
361,0,366,540,106,295,1307
362,0,161,238,47,131,577
363,0,1651,2436,478,1333,5898
364,0,3271,7350,2090,3986,16697
365,0,2627,3786,719,2073,9205
366,0,1184,3470,1123,1873,7650
367,0,952,1307,232,717,3208
368,0,822,1123,197,615,2757
369,0,3614,4937,867,2708,12126
370,0,229,312,54,171,766
371,0,399,982,294,532,2207
372,0,932,1667,402,908,3909
373,0,83,215,65,117,480
374,0,100,246,74,134,554
375,22962,4627,9877,2721,5361,22586
376,0,2846,12188,3870,5912,24816
377,0,2846,12188,3870,5912,24816
378,0,4627,9877,2721,5361,22586
379,0,2683,11637,3686,5619,23625
380,0,0,0,0,0,0
381,0,0,0,0,0,0
382,0,0,0,0,0,0
383,0,15,18,3,10,46
384,0,4612,9858,2719,5351,22540
385,0,165,551,183,293,1192
386,0,0,0,0,0,0
387,0,165,551,183,293,1192
388,0,0,0,0,0,0
389,0,15,18,3,10,46
390,0,2683,11637,3686,5619,23625
391,0,0,0,0,0,0
392,0,165,551,183,293,1192
393,0,15,18,3,10,46
394,0,0,0,0,0,0
395,0,4612,9858,2719,5351,22540
396,0,2683,11637,3686,5619,23625
397,0,165,551,183,293,1192
398,1206,15,18,3,10,46
399,3877,535,2512,784,1180,5011
400,0,4612,9858,2719,5351,22540
401,3877,535,2512,784,1180,5011
402,0,535,2512,784,1180,5011
403,1206,165,551,183,293,1192
404,0,15,18,3,10,46
405,3877,932,1667,402,908,3909
406,0,535,2512,784,1180,5011
407,0,932,1667,402,908,3909
408,0,932,1667,402,908,3909
409,0,932,1667,402,908,3909
410,0,535,2512,784,1180,5011
411,0,932,1667,402,908,3909
412,0,535,2512,784,1180,5011
413,0,0,0,0,0,0
414,0,0,0,0,0,0
415,0,932,1667,402,908,3909
416,0,535,2512,784,1180,5011
417,0,166,276,287,131,860
418,0,198,315,293,153,959
419,0,6,55,16,22,99
420,0,1090,1911,676,992,4669
421,0,695,2734,1056,1289,5774
422,0,1090,1911,676,992,4669
423,0,695,2734,1056,1289,5774
424,0,1090,1911,676,992,4669
425,0,4612,9858,2719,5351,22540
426,0,695,2734,1056,1289,5774
427,0,0,0,0,0,0
428,0,2683,11637,3686,5619,23625
429,0,0,0,0,0,0
430,0,1090,1911,676,992,4669
431,0,695,2734,1056,1289,5774
432,0,1090,1911,676,992,4669
433,0,2683,11637,3686,5619,23625
434,0,4612,9858,2719,5351,22540
435,0,165,551,183,293,1192
436,0,15,18,3,10,46
437,0,695,2734,1056,1289,5774
438,0,1090,1911,676,992,4669
439,0,695,2734,1056,1289,5774
440,0,1090,1911,676,992,4669
441,23572,4612,9858,2719,5351,22540
442,0,695,2734,1056,1289,5774
443,0,0,0,0,0,0
444,0,165,551,183,293,1192
445,0,15,18,3,10,46
446,0,0,0,0,0,0
447,0,1090,1911,676,992,4669
448,0,695,2734,1056,1289,5774
449,0,1090,1911,676,992,4669
450,0,165,551,183,293,1192
451,0,15,18,3,10,46
452,0,695,2734,1056,1289,5774
453,0,165,551,183,293,1192
454,0,15,18,3,10,46
455,0,162,526,176,283,1147
456,0,943,1402,503,718,3566
457,0,695,2734,1056,1289,5774
458,0,165,551,183,293,1192
459,0,14,18,3,10,45
460,0,697,2757,1063,1299,5816
461,0,943,1402,503,718,3566
462,0,697,2757,1063,1299,5816
463,0,0,0,0,0,0
464,0,0,0,0,0,0
465,8308,943,1402,503,718,3566
466,21595,2683,11637,3686,5619,23625
467,0,2683,11637,3686,5619,23625
468,0,4612,9858,2719,5351,22540
469,0,4612,9858,2719,5351,22540
470,0,697,2757,1063,1299,5816
471,0,943,1402,503,718,3566
472,0,2683,11637,3686,5619,23625
473,0,4612,9858,2719,5351,22540
474,0,697,2757,1063,1299,5816
475,0,943,1402,503,718,3566
476,0,697,2757,1063,1299,5816
477,0,943,1402,503,718,3566
478,0,697,2757,1063,1299,5816
479,0,0,0,0,0,0
480,0,0,0,0,0,0
481,0,943,1402,503,718,3566
482,0,195,382,380,180,1137
483,0,697,2757,1063,1299,5816
484,0,243,333,291,121,988
485,0,40,55,24,26,145
486,0,1146,1680,769,812,4407
487,0,0,0,0,0,0
488,0,1146,1680,769,812,4407
489,0,834,3016,1387,1424,6661
490,0,0,0,0,0,0
491,0,834,3016,1387,1424,6661
492,0,1146,1680,769,812,4407
493,0,834,3016,1387,1424,6661
494,0,1146,1680,769,812,4407
495,0,834,3016,1387,1424,6661
496,0,1146,1680,769,812,4407
497,0,2683,11637,3686,5619,23625
498,0,4612,9858,2719,5351,22540
499,0,834,3016,1387,1424,6661
500,0,0,0,0,0,0
501,0,0,0,0,0,0
502,0,1146,1680,769,812,4407
503,0,834,3016,1387,1424,6661
504,0,1146,1680,769,812,4407
505,0,2683,11637,3686,5619,23625
506,0,175,219,33,121,548
507,0,4436,9639,2686,5230,21991
508,0,33,307,88,121,549
509,0,890,2488,1542,1469,6389
510,0,922,2795,1629,1590,6936
511,0,834,3016,1387,1424,6661
512,0,97,260,283,118,758
513,0,1336,1914,927,879,5056
514,0,909,3235,1640,1526,7310
515,0,0,0,0,0,0
516,0,212,274,187,84,757
517,0,97,260,283,118,758
518,0,0,0,0,0,0
519,0,1336,1914,927,879,5056
520,0,0,0,0,0,0
521,2823,1065,2707,1575,1590,6937
522,0,33,307,88,121,549
523,0,1201,1797,905,865,4768
524,0,212,274,187,84,757
525,308,97,260,283,118,758
526,0,909,3235,1640,1526,7310
527,0,0,0,0,0,0
528,0,909,3235,1640,1526,7310
529,0,262,377,203,199,1041
530,2823,1234,2104,993,986,5317
531,0,106,906,268,135,1415
532,0,0,0,0,0,0
533,0,1336,1914,927,879,5056
534,0,1598,2291,1130,1079,6098
535,0,1108,1639,745,786,4278
536,0,490,651,385,293,1819
537,0,231,1370,516,335,2452
538,0,0,0,0,0,0
539,0,0,0,0,0,0
540,0,490,651,385,293,1819
541,0,4436,9639,2686,5230,21991
542,0,2650,11330,3599,5498,23077
543,0,890,2488,1542,1469,6389
544,0,5636,11437,3591,6095,26759
545,0,3538,13817,5140,6968,29463
546,0,100,268,291,122,781
547,308,212,274,187,84,757
548,0,6,8,7,2,23
549,0,424,667,599,281,1971
550,0,231,1370,516,335,2452
551,0,540,721,502,290,2053
552,0,332,1413,618,329,2692
553,0,540,721,502,290,2053
554,0,332,1413,618,329,2692
555,0,540,721,502,290,2053
556,0,3,8,8,4,23
557,0,6,8,7,2,23
558,0,3,8,8,4,23
559,0,6,8,7,2,23
560,0,3,8,8,4,23
561,0,6,8,7,2,23
562,0,3,8,8,4,23
563,134,6,8,7,2,23
564,0,332,1413,618,329,2692
565,0,540,721,502,290,2053
566,134,3,8,8,4,23
567,0,6,8,7,2,23
568,0,332,1413,618,329,2692
569,0,540,721,502,290,2053
570,0,3,8,8,4,23
571,0,6,8,7,2,23
572,0,332,1413,618,329,2692
573,0,0,0,0,0,0
574,0,0,0,0,0,0
575,0,540,721,502,290,2053
576,0,0,0,0,0,0
577,0,332,1413,618,329,2692
578,5377,540,721,502,290,2053
579,0,3,8,8,4,23
580,0,6,8,7,2,23
581,0,3,8,8,4,23
582,0,6,8,7,2,23
583,0,0,0,0,0,0
584,823,0,0,0,0,0
585,0,0,0,0,0,0
586,823,0,0,0,0,0
587,0,0,0,0,0,0
588,0,426,686,643,313,2068
589,5377,332,1413,618,329,2692
590,0,873,1255,1025,464,3617
591,0,3538,13817,5140,6968,29463
592,0,3,8,8,4,23
593,0,6,8,7,2,23
594,25610,5636,11437,3591,6095,26759
595,0,0,0,0,0,0
596,0,3,8,8,4,23
597,0,6,8,7,2,23
598,0,3,8,8,4,23
599,0,6,8,7,2,23
600,0,3,8,8,4,23
601,0,6,8,7,2,23
602,0,0,0,0,0,0
603,0,0,0,0,0,0
604,0,3,8,8,4,23
605,0,6,8,7,2,23
606,0,653,1901,1147,559,4260
607,0,873,1255,1025,464,3617
608,0,653,1901,1147,559,4260
609,0,873,1255,1025,464,3617
610,0,0,0,0,0,0
611,0,0,0,0,0,0
612,0,6,8,7,2,23
613,0,0,0,0,0,0
614,0,3,8,8,4,23
615,0,3,8,8,4,23
616,0,6,8,7,2,23
617,0,653,1901,1147,559,4260
618,0,873,1255,1025,464,3617
619,0,653,1901,1147,559,4260
620,7144,873,1255,1025,464,3617
621,7144,653,1901,1147,559,4260
622,0,873,1255,1025,464,3617
623,0,309,375,263,135,1082
624,0,212,474,478,210,1374
625,0,653,1901,1147,559,4260
626,0,1181,1840,1599,683,5303
627,0,399,982,294,532,2207
628,0,266,1045,337,523,2171
629,0,266,1045,337,523,2171
630,0,399,982,294,532,2207
631,0,522,520,381,228,1651
632,0,1022,2453,1689,786,5950
633,0,1294,2208,2120,826,6448
634,0,399,982,294,532,2207
635,0,266,1045,337,523,2171
636,0,5636,11437,3591,6095,26759
637,0,266,1045,337,523,2171
638,0,399,982,294,532,2207
639,0,1436,2780,1947,934,7097
640,9105,1294,2208,2120,826,6448
641,9105,1436,2780,1947,934,7097
642,0,1294,2208,2120,826,6448
643,0,1436,2780,1947,934,7097
644,0,1294,2208,2120,826,6448
645,0,3538,13817,5140,6968,29463
646,0,266,1045,337,523,2171
647,0,399,982,294,532,2207
648,0,1436,2780,1947,934,7097
649,0,1294,2208,2120,826,6448
650,0,399,982,294,532,2207
651,0,266,1045,337,523,2171
652,0,1436,2780,1947,934,7097
653,0,1294,2208,2120,826,6448
654,0,5636,11437,3591,6095,26759
655,0,1436,2780,1947,934,7097
656,0,1294,2208,2120,826,6448
657,0,266,1045,337,523,2171
658,0,399,982,294,532,2207
659,0,266,1045,337,523,2171
660,0,399,982,294,532,2207
661,0,1436,2780,1947,934,7097
662,0,1294,2208,2120,826,6448
663,0,266,1045,337,523,2171
664,0,399,982,294,532,2207
665,0,229,531,510,232,1502
666,0,1436,2780,1947,934,7097
667,0,1582,2644,2451,960,7637
668,0,266,1045,337,523,2171
669,0,399,982,294,532,2207
670,0,266,1045,337,523,2171
671,0,399,982,294,532,2207
672,0,1599,3189,2381,1117,8286
673,0,416,955,979,443,2793
674,10260,2085,3319,2949,1183,9536
675,0,689,1006,729,353,2777
676,0,416,955,979,443,2793
677,0,689,1006,729,353,2777
678,0,416,955,979,443,2793
679,0,689,1006,729,353,2777
680,2523,416,955,979,443,2793
681,2523,689,1006,729,353,2777
682,2399,416,955,979,443,2793
683,2399,689,1006,729,353,2777
684,0,416,955,979,443,2793
685,0,550,1238,1276,570,3634
686,0,689,1006,729,353,2777
687,0,213,291,248,99,851
688,24043,3538,13817,5140,6968,29463
689,0,5636,11437,3591,6095,26759
690,0,295,770,840,342,2247
691,0,7,14,11,4,36
692,0,675,864,605,265,2409
693,0,52,75,60,22,209
694,0,7,14,11,4,36
695,0,3968,9139,2963,4836,20906
696,0,1670,2298,627,1260,5855
697,0,3042,11656,4124,5705,24527
698,0,266,1045,337,523,2171
699,2189,399,982,294,532,2207
700,0,293,767,835,340,2235
701,0,675,864,605,265,2409
702,0,52,75,60,22,209
703,0,7,14,11,4,36
704,0,134,284,297,127,842
705,0,213,291,248,99,851
706,0,52,75,60,22,209
707,0,7,14,11,4,36
708,0,52,75,60,22,209
709,0,7,14,11,4,36
710,0,202,492,487,217,1398
711,0,293,767,835,340,2235
712,0,1017,1370,965,422,3774
713,0,3968,9139,2963,4836,20906
714,0,496,2160,1016,1263,4935
715,0,1000,1293,937,392,3622
716,0,171,420,465,186,1242
717,0,2136,3295,2875,1244,9550
718,0,3042,11656,4124,5705,24527
719,0,1306,2422,2403,1039,7170
720,0,490,1246,1313,553,3602
721,0,479,2083,988,1232,4782
722,0,2136,3295,2875,1244,9550
723,0,798,2909,1836,1599,7142
724,0,914,1075,753,407,3149
725,10260,1829,3813,3129,1429,10200
726,0,2178,4057,3850,1583,11668
727,0,389,1143,581,597,2710
728,0,530,1225,529,596,2880
729,0,3425,5092,3185,2321,14023
730,0,380,500,318,183,1381
731,11209,3425,5092,3185,2321,14023
732,0,798,2909,1836,1599,7142
733,0,1485,2830,2447,1118,7880
734,0,1903,5239,3965,2535,13642
735,0,52,75,60,22,209
736,0,7,14,11,4,36
737,0,530,1225,529,596,2880
738,0,389,1143,581,597,2710
739,0,2537,4537,3563,1711,12348
740,0,2178,4057,3850,1583,11668
741,0,218,342,258,129,947
742,9590,3277,4914,3075,2258,13524
743,0,317,512,395,172,1396
744,11209,1903,5239,3965,2535,13642
745,0,69,164,149,66,448
746,2189,266,1045,337,523,2171
747,0,399,982,294,532,2207
748,0,389,1143,581,597,2710
749,0,530,1225,529,596,2880
750,0,52,75,60,22,209
751,0,7,14,11,4,36
752,0,298,595,525,223,1641
753,0,2537,4537,3563,1711,12348
754,0,2435,4523,4193,1743,12894
755,0,0,0,0,0,0
756,0,3277,4914,3075,2258,13524
757,9590,1843,5011,3799,2420,13073
758,0,0,0,0,0,0
759,0,266,1045,337,523,2171
760,0,399,982,294,532,2207
761,0,389,1143,581,597,2710
762,0,530,1225,529,596,2880
763,0,52,75,60,22,209
764,0,7,14,11,4,36
765,0,134,284,297,127,842
766,0,213,291,248,99,851
767,0,2756,4984,3956,1880,13576
768,14956,2435,4523,4193,1743,12894
769,0,530,1225,529,596,2880
770,0,389,1143,581,597,2710
771,0,0,0,0,0,0
772,0,3277,4914,3075,2258,13524
773,0,1843,5011,3799,2420,13073
774,0,0,0,0,0,0
775,0,0,0,0,0,0
776,0,3277,4914,3075,2258,13524
777,14956,2756,4984,3956,1880,13576
778,0,2435,4523,4193,1743,12894
779,0,1843,5011,3799,2420,13073
780,0,0,0,0,0,0
781,0,266,1045,337,523,2171
782,0,399,982,294,532,2207
783,0,2756,4984,3956,1880,13576
784,0,1843,5011,3799,2420,13073
785,0,3529,5276,3603,2258,14666
786,0,389,1143,581,597,2710
787,0,530,1225,529,596,2880
788,0,52,75,60,22,209
789,0,7,14,11,4,36
790,0,4348,14079,6527,6743,31697
791,0,228,570,612,257,1667
792,0,266,1045,337,523,2171
793,0,850,1546,704,702,3802
794,0,480,1581,941,764,3766
795,0,850,1546,704,702,3802
796,29455,5452,11969,5410,5954,28785
797,0,480,1581,941,764,3766
798,0,850,1546,704,702,3802
799,0,389,1143,581,597,2710
800,0,530,1225,529,596,2880
801,0,389,1143,581,597,2710
802,0,530,1225,529,596,2880
803,0,134,284,297,127,842
804,0,213,291,248,99,851
805,0,134,284,297,127,842
806,0,213,291,248,99,851
807,0,52,75,60,22,209
808,0,7,14,11,4,36
809,0,389,1143,581,597,2710
810,0,530,1225,529,596,2880
811,0,480,1581,941,764,3766
812,0,850,1546,704,702,3802
813,0,299,515,428,161,1403
814,0,2417,5834,4090,2557,14898
815,0,3768,5757,4037,2434,15996
816,0,134,284,297,127,842
817,2699,213,291,248,99,851
818,0,2715,6349,4518,2719,16301
819,0,3768,5757,4037,2434,15996
820,0,2715,6349,4518,2719,16301
821,0,3768,5757,4037,2434,15996
822,0,52,75,60,22,209
823,0,7,14,11,4,36
824,0,530,1225,529,596,2880
825,0,389,1143,581,597,2710
826,0,530,1225,529,596,2880
827,0,389,1143,581,597,2710
828,0,480,1581,941,764,3766
829,0,850,1546,704,702,3802
830,0,248,486,488,185,1407
831,2699,134,284,297,127,842
832,0,686,1429,842,544,3501
833,3353,512,1071,710,482,2775
834,0,52,75,60,22,209
835,0,7,14,11,4,36
836,0,530,1225,529,596,2880
837,0,389,1143,581,597,2710
838,0,389,1143,581,597,2710
839,0,530,1225,529,596,2880
840,0,480,1581,941,764,3766
841,0,850,1546,704,702,3802
842,0,547,1265,950,568,3330
843,0,686,1429,842,544,3501
844,0,480,1581,941,764,3766
845,0,850,1546,704,702,3802
846,0,389,1143,581,597,2710
847,0,530,1225,529,596,2880
848,0,389,1143,581,597,2710
849,0,530,1225,529,596,2880
850,0,547,1265,950,568,3330
851,0,686,1429,842,544,3501
852,0,389,1143,581,597,2710
853,0,530,1225,529,596,2880
854,0,870,1182,906,400,3358
855,0,2715,6349,4518,2719,16301
856,0,547,1265,950,568,3330
857,0,3384,5131,3673,2138,14326
858,0,389,1143,581,597,2710
859,0,530,1225,529,596,2880
860,0,547,1265,950,568,3330
861,0,686,1429,842,544,3501
862,0,547,1265,950,568,3330
863,0,686,1429,842,544,3501
864,0,686,1429,842,544,3501
865,0,547,1265,950,568,3330
866,0,247,557,585,251,1640
867,0,480,1581,941,764,3766
868,0,1263,2114,1120,884,5381
869,0,389,1143,581,597,2710
870,0,530,1225,529,596,2880
871,0,530,1225,529,596,2880
872,0,389,1143,581,597,2710
873,0,52,75,60,22,209
874,0,7,14,11,4,36
875,0,389,1143,581,597,2710
876,0,530,1225,529,596,2880
877,0,28,38,29,10,105
878,0,14,38,38,15,105
879,0,59,225,73,115,472
880,0,83,215,65,117,480
881,0,389,1143,581,597,2710
882,0,530,1225,529,596,2880
883,0,389,1143,581,597,2710
884,0,530,1225,529,596,2880
885,0,59,138,126,58,381
886,0,389,1143,581,597,2710
887,0,615,1355,612,635,3217
888,0,14,38,38,15,105
889,0,28,38,29,10,105
890,0,59,225,73,115,472
891,0,83,215,65,117,480
892,0,530,1225,529,596,2880
893,0,389,1143,581,597,2710
894,0,530,1225,529,596,2880
895,600,389,1143,581,597,2710
896,0,33,34,26,9,102
897,0,14,38,38,15,105
898,0,11,23,22,9,65
899,0,28,38,29,10,105
900,0,14,38,38,15,105
901,0,18,21,19,8,66
902,0,11,23,22,9,65
903,0,2573,5521,4006,2367,14467
904,0,3384,5131,3673,2138,14326
905,0,71,137,115,48,371
906,0,18,21,19,8,66
907,0,72,144,107,53,376
908,28448,4348,14079,6527,6743,31697
909,0,74,138,115,49,376
910,1251,72,144,107,53,376
911,0,5452,11969,5410,5954,28785
912,0,52,75,60,22,209
913,0,28,38,29,10,105
914,0,21,52,48,19,140
915,1251,74,138,115,49,376
916,0,72,144,107,53,376
917,0,2573,5521,4006,2367,14467
918,0,74,138,115,49,376
919,0,3310,4993,3558,2090,13951
920,0,710,2115,1515,1006,5346
921,0,1263,2114,1120,884,5381
922,0,80,113,89,33,315
923,631,21,52,48,19,140
924,631,80,113,89,33,315
925,0,21,52,48,19,140
926,0,2501,5377,3899,2314,14091
927,7915,3310,4993,3558,2090,13951
928,600,530,1225,529,596,2880
929,0,389,1143,581,597,2710
930,0,440,1266,695,649,3050
931,602,615,1355,612,635,3217
932,0,80,113,89,33,315
933,0,21,52,48,19,140
934,0,31,61,38,21,151
935,0,29,55,61,23,168
936,0,80,113,89,33,315
937,0,21,52,48,19,140
938,7915,2501,5377,3899,2314,14091
939,0,3310,4993,3558,2090,13951
940,0,29,55,61,23,168
941,0,31,61,38,21,151
942,0,59,225,73,115,472
943,0,83,215,65,117,480
944,602,440,1266,695,649,3050
945,0,615,1355,612,635,3217
946,0,80,113,89,33,315
947,0,21,52,48,19,140
948,0,2501,5377,3899,2314,14091
949,0,3310,4993,3558,2090,13951
950,0,710,2115,1515,1006,5346
951,0,530,1225,529,596,2880
952,0,864,1222,772,443,3301
953,0,59,225,73,115,472
954,0,83,215,65,117,480
955,0,211,542,557,242,1552
956,0,31,61,38,21,151
957,0,375,511,375,156,1417
958,0,2501,5377,3899,2314,14091
959,0,2980,4454,3185,1945,12564
960,0,329,539,373,145,1386
961,0,31,61,38,21,151
962,0,29,55,61,23,168
963,0,2202,4721,3379,2086,12388
964,0,2980,4454,3185,1945,12564
965,0,385,792,717,342,2236
966,0,440,1266,695,649,3050
967,0,1110,2094,1178,910,5292
968,0,299,656,520,228,1703
969,0,329,539,373,145,1386
970,0,110,240,214,93,657
971,0,801,2024,1381,979,5185
972,0,1215,2253,1272,963,5703
973,9167,2980,4454,3185,1945,12564
974,0,2202,4721,3379,2086,12388
975,3353,525,1151,708,499,2883
976,0,512,1071,710,482,2775
977,0,299,656,520,228,1703
978,0,329,539,373,145,1386
979,0,80,113,89,33,315
980,0,21,52,48,19,140
981,0,525,1151,708,499,2883
982,0,512,1071,710,482,2775
983,0,866,2176,1520,1047,5609
984,0,1215,2253,1272,963,5703
985,0,182,487,513,219,1401
986,0,375,511,375,156,1417
987,0,46,117,113,46,322
988,0,80,113,89,33,315
989,935,47,74,55,19,195
990,0,525,1151,708,499,2883
991,0,866,2176,1520,1047,5609
992,0,974,1559,1001,649,4183
993,0,299,656,520,228,1703
994,0,329,539,373,145,1386
995,9167,2202,4721,3379,2086,12388
998,0,2980,4454,3185,1945,12564
999,0,452,1304,1115,566,3437
1000,0,864,1222,772,443,3301
1001,0,637,1563,1247,748,4195
1002,0,974,1559,1001,649,4183
1003,0,299,656,520,228,1703
1004,0,329,539,373,145,1386
1005,0,452,1304,1115,566,3437
1006,0,864,1222,772,443,3301
1007,0,2202,4721,3379,2086,12388
1010,0,2980,4454,3185,1945,12564
1011,0,202,545,436,85,1268
1012,0,299,656,520,228,1703
1013,0,457,1087,900,254,2698
1014,935,28,72,70,29,199
1015,0,47,74,55,19,195
1016,0,59,225,73,115,472
1017,0,83,215,65,117,480
1018,0,2202,4721,3379,2086,12388
1019,0,2980,4454,3185,1945,12564
1020,0,452,1304,1115,566,3437
1021,0,864,1222,772,443,3301
1022,0,28,72,70,29,199
1023,0,47,74,55,19,195
1024,0,5452,11969,5410,5954,28785
1025,0,637,1563,1247,748,4195
1026,0,974,1559,1001,649,4183
1027,0,2202,4721,3379,2086,12388
1030,0,2980,4454,3185,1945,12564
1031,0,59,225,73,115,472
1032,0,83,215,65,117,480
1033,0,252,576,549,222,1599
1034,0,501,1200,957,313,2971
1035,0,804,1638,1306,436,4184
1036,0,28,72,70,29,199
1037,0,47,74,55,19,195
1038,0,166,296,399,152,1013
1039,0,637,1563,1247,748,4195
1040,0,1233,1961,1309,777,5280
1041,0,28,72,70,29,199
1042,0,47,74,55,19,195
1043,0,809,948,725,433,2915
1044,0,2202,4721,3379,2086,12388
1045,9932,3112,4784,3584,2253,13733
1046,0,182,487,513,219,1401
1047,0,375,511,375,156,1417
1048,0,452,1304,1115,566,3437
1049,0,864,1222,772,443,3301
1050,0,804,1859,1647,901,5211
1051,0,1233,1961,1309,777,5280
1052,0,804,1859,1647,901,5211
1053,0,1233,1961,1309,777,5280
1054,0,452,1304,1115,566,3437
1055,0,864,1222,772,443,3301
1056,0,28,72,70,29,199
1057,0,47,74,55,19,195
1058,0,804,1859,1647,901,5211
1059,3461,1233,1961,1309,777,5280
1060,0,131,281,202,73,687
1061,0,108,222,187,86,603
1062,9932,2679,5042,3597,2300,13618
1063,0,3112,4784,3584,2253,13733
1064,0,59,225,73,115,472
1065,0,44,116,36,62,258
1066,0,40,98,30,53,221
1067,0,242,669,715,293,1919
1068,0,108,222,187,86,603
1069,0,641,943,650,286,2520
1070,0,1,4,2,1,8
1071,0,28,72,70,29,199
1072,0,46,70,54,18,188
1073,0,29,55,61,23,168
1074,0,452,1304,1115,566,3437
1075,0,848,1190,730,429,3197
1076,0,734,1737,1470,520,4461
1077,0,804,1638,1306,436,4184
1078,0,32,119,39,61,251
1079,0,44,116,36,62,258
1080,0,335,857,866,377,2435
1081,0,641,943,650,286,2520
1082,3461,804,1859,1647,901,5211
1083,0,1233,1961,1309,777,5280
1084,0,28,105,34,53,220
1085,0,40,98,30,53,221
1086,0,804,1859,1647,901,5211
1087,0,1233,1961,1309,777,5280
1088,0,26,68,66,27,187
1089,0,46,70,54,18,188
1090,0,2679,5042,3597,2300,13618
1091,0,3112,4784,3584,2253,13733
1092,0,26,68,66,27,187
1093,0,46,70,54,18,188
1094,0,804,1859,1647,901,5211
1095,0,1009,2365,1411,571,5356
1096,0,869,1619,1308,207,4003
1097,0,26,68,66,27,187
1098,0,46,70,54,18,188
1099,0,26,68,66,27,187
1100,716,46,70,54,18,188
1101,716,26,68,66,27,187
1102,0,46,70,54,18,188
1103,0,335,857,866,377,2435
1104,0,641,943,650,286,2520
1105,0,734,1737,1470,520,4461
1106,0,26,68,66,27,187
1107,0,25,221,133,35,414
1108,0,835,1677,1292,418,4222
1109,0,32,119,39,61,251
1110,0,44,116,36,62,258
1111,0,55,109,50,29,243
1112,0,25,221,133,35,414
1113,0,948,2183,1803,648,5582
1114,0,1009,2365,1411,571,5356
1115,0,55,109,50,29,243
1116,1123,25,221,133,35,414
1117,0,434,1266,1097,553,3350
1118,0,848,1190,730,429,3197
1119,0,502,1700,1253,253,3708
1120,0,869,1619,1308,207,4003
1121,1123,55,109,50,29,243
1122,0,25,221,133,35,414
1123,0,2673,3767,2741,2235,11416
1124,0,438,1017,844,18,2317
1125,0,948,2183,1803,648,5582
1126,0,1009,2365,1411,571,5356
1127,0,55,109,50,29,243
1128,0,25,221,133,35,414
1129,0,502,1700,1253,253,3708
1130,0,869,1619,1308,207,4003
1131,0,2679,5042,3597,2300,13618
1132,0,55,109,50,29,243
1133,0,509,1166,960,640,3275
1134,0,310,1210,694,30,2244
1135,0,509,1166,959,630,3264
1136,0,3372,4923,3457,2788,14540
1137,0,1009,2365,1411,571,5356
1138,0,948,2183,1803,648,5582
1139,0,140,182,125,49,496
1140,0,461,447,309,159,1376
1141,0,715,1886,1552,517,4670
1142,0,700,1731,1520,487,4438
1143,0,1009,2365,1411,571,5356
1144,0,948,2183,1803,648,5582
1145,0,1009,2365,1411,571,5356
1146,0,948,2183,1803,648,5582
1147,0,2909,4887,3780,2904,14480
1148,0,3372,4923,3457,2788,14540
1149,0,182,487,513,219,1401
1150,0,375,511,375,156,1417
1151,0,948,2183,1803,648,5582
1152,0,1009,2365,1411,571,5356
1153,0,502,1700,1253,253,3708
1154,0,869,1619,1308,207,4003
1155,0,502,1700,1253,253,3708
1156,0,869,1619,1308,207,4003
1157,0,5452,11969,5410,5954,28785
1158,0,99,212,181,87,579
1159,0,131,281,202,73,687
1160,0,12,14,11,1,38
1161,0,4348,14079,6527,6743,31697
1162,0,5135,11253,4955,5624,26967
1163,0,317,717,456,330,1820
1164,0,247,733,667,286,1933
1165,0,335,857,866,377,2435
1166,0,1141,1570,1076,491,4278
1167,0,502,1700,1253,253,3708
1168,0,869,1619,1308,207,4003
1169,0,2909,4887,3780,2904,14480
1170,0,3372,4923,3457,2788,14540
1171,0,4348,14079,6527,6743,31697
1172,0,5135,11253,4955,5624,26967
1173,0,383,455,315,146,1299
1174,0,90,244,260,113,707
1175,0,972,1923,1475,518,4888
1176,0,454,717,683,334,2188
1177,0,493,1573,1379,379,3824
1178,0,3372,4923,3457,2788,14540
1179,0,513,756,643,348,2260
1180,0,454,717,683,334,2188
1181,0,2909,4887,3780,2904,14480
1182,8374,3372,4923,3457,2788,14540
1216,0,72,93,59,25,249
1183,0,513,756,643,348,2260
1184,0,404,676,668,331,2079
1185,0,434,1266,1097,553,3350
1186,0,848,1190,730,429,3197
1187,0,502,1700,1253,253,3708
1188,0,869,1619,1308,207,4003
1189,0,570,1548,1494,654,4266
1190,0,1141,1570,1076,491,4278
1191,0,4098,13397,6196,6475,30166
1192,0,848,1724,1274,378,4224
1193,0,493,1573,1379,379,3824
1194,0,64,141,186,69,460
1195,0,1063,1644,1573,825,5105
1196,8374,2909,4887,3780,2904,14480
1197,0,3372,4923,3457,2788,14540
1198,0,507,712,591,330,2140
1199,0,50,127,134,43,354
1200,1708,355,549,533,288,1725
1201,0,83,196,118,28,425
1202,0,50,127,134,43,354
1203,0,502,1700,1253,253,3708
1204,0,869,1619,1308,207,4003
1205,0,434,1266,1097,553,3350
1206,0,848,1190,730,429,3197
1207,0,570,1548,1494,654,4266
1208,0,1141,1570,1076,491,4278
1209,0,250,682,331,268,1531
1210,0,748,916,514,408,2586
1211,0,403,1404,868,607,3282
1212,0,434,1633,1005,655,3727
1213,0,748,916,514,408,2586
1214,0,83,196,118,28,425
1215,0,50,127,134,43,354
1217,0,848,1724,1274,378,4224
1218,0,0,0,0,0,0
1219,0,493,1573,1379,379,3824
1220,0,4098,13397,6196,6475,30166
1221,0,1127,1786,1759,894,5566
1222,0,265,587,587,253,1692
1223,0,968,1370,709,629,3676
1224,0,216,1086,385,431,2118
1225,0,83,196,118,28,425
1226,0,50,127,134,43,354
1227,0,434,1266,1097,553,3350
1228,0,848,1190,730,429,3197
1229,0,570,1548,1494,654,4266
1230,0,1141,1570,1076,491,4278
1231,1708,424,516,473,302,1715
1232,0,355,549,533,288,1725
1233,0,370,1492,818,586,3266
1234,0,1811,2560,2087,1234,7692
1235,0,0,0,0,0,0
1236,0,0,0,0,0,0
1237,0,5135,11253,4955,5624,26967
1238,0,570,1548,1494,654,4266
1239,0,1141,1570,1076,491,4278
1240,0,218,223,150,71,662
1241,0,0,0,0,0,0
1242,0,1154,1643,1188,859,4844
1243,0,705,1405,920,783,3813
1244,0,848,1724,1274,378,4224
1245,6525,493,1573,1379,379,3824
1246,0,2909,4887,3780,2904,14480
1247,0,83,196,118,28,425
1248,0,1135,1757,1338,1033,5263
1249,0,2275,3274,2238,1787,9574
1250,0,370,1492,818,586,3266
1251,0,1783,2651,2097,1251,7782
1252,0,1114,2277,1857,830,6078
1253,0,502,1700,1253,253,3708
1254,0,570,1548,1494,654,4266
1255,0,1786,2018,1464,1205,6473
1256,0,2633,4233,3321,1465,11652
1257,0,792,1368,813,772,3745
1258,3075,1154,1643,1188,859,4844
1259,0,1549,2896,2384,1258,8087
1260,0,1786,2018,1464,1205,6473
1261,0,1931,3414,2766,1622,9733
1262,0,2633,4233,3321,1465,11652
1263,3075,792,1368,813,772,3745
1264,0,1154,1643,1188,859,4844
1265,0,1057,1150,864,887,3958
1266,0,1135,1757,1338,1033,5263
1267,0,1549,2896,2384,1258,8087
1268,8332,1786,2018,1464,1205,6473
1269,0,424,516,473,302,1715
1270,0,792,1368,813,772,3745
1271,0,627,990,629,451,2697
1272,0,882,1202,1093,695,3872
1273,6525,848,1724,1274,378,4224
1274,0,493,1573,1379,379,3824
1275,0,441,1154,704,514,2813
1276,0,627,990,629,451,2697
1277,0,1223,1680,1180,844,4927
1278,0,705,1405,920,783,3813
1279,0,1057,1150,864,887,3958
1280,0,1135,1757,1338,1033,5263
1281,0,1139,3142,2229,1104,7614
1282,0,1783,2651,2097,1251,7782
1283,0,705,1405,920,783,3813
1284,8332,1549,2896,2384,1258,8087
1285,0,1786,2018,1464,1205,6473
1286,0,441,1154,704,514,2813
1287,0,627,990,629,451,2697
1288,0,1057,1150,864,887,3958
1289,0,1135,1757,1338,1033,5263
1290,0,1931,3414,2766,1622,9733
1291,0,2633,4233,3321,1465,11652
1292,0,1057,1150,864,887,3958
1293,6641,1135,1757,1338,1033,5263
1294,0,1223,1680,1180,844,4927
1295,0,1549,2896,2384,1258,8087
1296,0,1786,2018,1464,1205,6473
1297,0,1923,3914,3017,2035,10889
1298,0,441,1154,704,514,2813
1299,0,522,702,490,249,1963
1300,0,2002,2652,1950,1486,8090
1301,0,705,1405,920,783,3813
1302,0,1135,1757,1338,1033,5263
1303,0,0,0,0,0,0
1304,0,627,1023,353,510,2513
1305,0,216,1086,385,431,2118
1306,0,1931,3414,2766,1622,9733
1307,10912,2633,4233,3321,1465,11652
1308,0,1549,2896,2384,1258,8087
1309,0,1057,1142,864,887,3950
1310,0,729,876,600,318,2523
1311,0,1549,2896,2384,1258,8087
1312,0,1223,1680,1180,844,4927
1314,6641,1057,1150,864,887,3958
1315,0,0,0,0,0,0
1316,0,775,730,582,560,2647
1317,0,882,1202,1093,695,3872
1318,0,1057,1150,864,887,3958
1319,0,414,1139,1046,225,2824
1320,0,1057,1142,864,887,3950
1322,0,705,1405,920,783,3813
1323,0,848,1724,1274,378,4224
1324,0,1223,1680,1180,844,4927
1325,0,591,1775,1519,431,4316
1326,0,311,720,593,306,1930
1327,0,522,702,490,249,1963
1328,0,1827,2574,1961,1159,7521
1330,0,342,1033,633,115,2123
1331,0,1044,2921,2273,1072,7310
1332,0,323,928,794,210,2255
1334,0,1044,2921,2273,1072,7310
1335,0,0,8,0,0,8
1336,0,414,1139,1046,225,2824
1338,0,1783,2651,2097,1251,7782
1339,0,1827,2574,1961,1159,7521
1341,0,1827,2574,1961,1159,7521
1342,0,311,720,593,306,1930
1343,0,522,702,490,249,1963
1344,0,40,98,30,53,221
1345,0,28,105,34,53,220
1346,0,5226,15182,7956,7369,35733
1347,0,1044,2921,2273,1072,7310
1348,0,1139,3142,2229,1104,7614
1350,0,775,730,582,560,2647
1351,0,882,1202,1093,695,3872
1353,0,1044,2921,2273,1072,7310
1354,6058,1783,2651,2097,1251,7782
1355,0,311,720,593,306,1930
1356,0,522,702,490,249,1963
1357,0,627,1023,353,510,2513
1358,0,216,1086,385,431,2118
1359,0,414,1147,1046,225,2832
1360,0,311,720,593,306,1930
1361,0,878,1015,687,353,2933
1362,0,1139,3142,2229,1104,7614
1363,0,28,105,34,53,220
1364,0,40,98,30,53,221
1365,0,317,732,747,320,2116
1366,0,1851,2606,1971,1176,7604
1367,0,248,372,241,134,995
1368,31266,6249,13529,6810,6455,33043
1369,0,365,469,360,143,1337
1370,0,1675,3439,2701,1738,9553
1371,0,1872,2604,2014,1462,7952
1372,0,1851,2606,1971,1176,7604
1373,6058,1139,3142,2229,1104,7614
1374,0,134,348,358,147,987
1375,0,351,1304,1235,319,3209
1376,0,878,1015,687,353,2933
1377,0,1026,3118,2346,1117,7607
1378,0,434,1266,1097,553,3350
1379,0,28,105,34,53,220
1380,0,835,1121,705,392,3053
1381,0,414,1702,1262,182,3560
1382,0,323,928,794,210,2255
1383,0,1851,2606,1971,1176,7604
1385,0,414,1702,1262,182,3560
1386,0,323,928,794,210,2255
1387,0,61,95,74,42,272
1388,0,1180,1673,1468,850,5171
1390,0,1851,2606,1971,1176,7604
1391,0,1026,3118,2346,1117,7607
1393,0,5,4,3,1,13
1394,0,5,39,47,2,93
1395,0,6,11,8,0,25
1396,0,334,670,605,277,1886
1397,0,775,730,582,560,2647
1398,0,359,566,450,197,1572
1400,0,1026,3118,2346,1117,7607
1401,0,1851,2606,1971,1176,7604
1402,0,0,0,0,0,0
1403,6142,1851,2606,1971,1176,7604
1404,0,1026,3118,2346,1117,7607
1405,0,40,98,30,53,221
1406,0,28,105,34,53,220
1407,0,0,0,0,0,0
1408,0,1026,3118,2346,1117,7607
1409,0,115,243,193,97,648
1410,0,1827,2574,1961,1159,7521
1411,0,358,607,449,219,1633
1412,0,0,0,0,0,0
1413,0,1180,1673,1468,850,5171
1414,0,1004,1169,1021,753,3947
1415,0,0,0,0,0,0
1416,0,501,845,727,287,2360
1417,6142,1026,3118,2346,1117,7607
1418,0,318,539,473,206,1536
1419,0,1739,3361,2633,1684,9417
1420,0,1872,2604,2014,1462,7952
1421,0,276,336,256,156,1024
1422,0,351,1304,1235,319,3209
1423,0,731,946,622,340,2639
1424,10912,1931,3414,2766,1622,9733
1425,0,2633,4233,3321,1465,11652
1426,0,408,1204,1075,516,3203
1427,0,67,99,52,30,248
1428,0,768,1022,653,362,2805
1429,0,627,1023,353,510,2513
1430,0,216,1086,385,431,2118
1431,0,1004,1169,1021,753,3947
1432,0,1739,3361,2633,1684,9417
1433,0,2905,4016,3269,2212,12402
1434,0,209,481,480,193,1363
1435,0,414,1702,1262,182,3560
1436,0,491,1114,904,255,2764
1437,0,325,1226,1073,297,2921
1438,0,731,946,622,340,2639
1439,0,2596,4268,3441,2338,12643
1440,5708,2905,4016,3269,2212,12402
1441,0,627,1023,353,510,2513
1442,0,216,1086,385,431,2118
1443,0,627,1023,353,510,2513
1444,3016,216,1086,385,431,2118
1445,0,182,487,513,219,1401
1446,0,355,684,593,240,1872
1447,0,769,1053,774,344,2940
1448,0,325,1226,1073,297,2921
1449,0,731,946,622,340,2639
1450,0,452,1871,1492,254,4069
1451,0,285,736,606,174,1801
1452,0,206,378,298,81,963
1453,0,297,1047,709,150,2203
1454,0,285,736,606,174,1801
1455,0,27,47,39,16,129
1456,0,29,79,79,29,216
1457,0,62,91,46,28,227
1458,0,693,842,573,297,2405
1459,0,325,1226,1073,297,2921
1460,0,452,798,728,353,2331
1461,0,224,472,435,182,1313
1462,0,276,518,432,187,1413
1463,0,287,501,397,141,1326
1464,0,260,509,434,170,1373
1465,0,276,518,432,187,1413
1466,0,374,2618,772,1097,4861
1467,0,1385,2043,401,1118,4947
1468,0,260,509,434,170,1373
1469,0,276,518,432,187,1413
1470,0,155,823,784,104,1866
1471,0,112,200,128,59,499
1472,0,94,178,169,22,463
1473,0,260,509,434,170,1373
1474,0,276,518,432,187,1413
1475,0,27,70,71,25,193
1476,0,62,91,46,28,227
1477,0,1931,3414,2766,1622,9733
1478,0,2633,4233,3321,1465,11652
1479,3016,627,1023,353,510,2513
1480,0,216,1086,385,431,2118
1481,0,654,1016,805,363,2838
1482,0,355,684,593,240,1872
1483,0,65,604,618,74,1361
1484,0,112,200,128,59,499
1485,0,491,1036,828,218,2573
1486,0,452,798,728,353,2331
1487,0,260,509,434,170,1373
1488,0,276,518,432,187,1413
1489,0,4,20,23,0,47
1490,0,6,11,8,0,25
1491,0,374,2618,772,1097,4861
1492,4892,1385,2043,401,1118,4947
1493,0,260,509,434,170,1373
1494,0,276,518,432,187,1413
1495,0,65,604,618,74,1361
1496,0,112,200,128,59,499
1497,0,4,20,23,0,47
1498,0,6,11,8,0,25
1499,0,654,1016,805,363,2838
1500,0,355,684,593,240,1872
1501,0,65,604,618,74,1361
1502,0,112,200,128,59,499
1503,0,491,1036,828,218,2573
1504,0,452,798,728,353,2331
1505,0,297,1047,709,150,2203
1506,6709,285,736,606,174,1801
1507,0,276,518,432,187,1413
1508,0,260,509,434,170,1373
1509,5708,2596,4268,3441,2338,12643
1510,0,941,1615,1409,650,4615
1511,0,1965,2401,1860,1562,7788
1512,0,65,604,618,74,1361
1513,0,112,200,128,59,499
1514,0,697,4977,1464,2075,9213
1515,9210,2627,3786,719,2073,9205
1516,0,444,1122,1120,485,3171
1517,0,277,697,699,284,1957
1518,0,1462,1999,1434,638,5533
1519,0,65,604,618,74,1361
1520,0,112,200,128,59,499
1521,0,627,1023,353,510,2513
1522,0,216,1086,385,431,2118
1523,0,65,604,618,74,1361
1524,0,112,200,128,59,499
1525,0,379,1124,996,487,2986
1526,3566,768,1022,653,362,2805
1527,0,769,1053,774,344,2940
1528,0,277,697,699,284,1957
1529,0,491,1036,828,218,2573
1530,0,452,798,728,353,2331
1531,0,2596,4268,3441,2338,12643
1532,0,65,604,618,74,1361
1533,0,434,730,499,193,1856
1534,0,1059,1998,1841,816,5714
1535,0,654,1016,805,363,2838
1536,0,355,684,593,240,1872
1537,6709,297,1047,709,150,2203
1538,0,285,736,606,174,1801
1539,0,654,1016,805,363,2838
1540,805,355,684,593,240,1872
1541,0,236,496,455,180,1367
1542,0,287,501,397,141,1326
1543,0,297,1047,709,150,2203
1544,0,285,736,606,174,1801
1545,0,1698,3676,3077,1840,10291
1546,0,2398,3131,2359,1755,9643
1547,0,277,697,699,284,1957
1548,0,769,1053,774,344,2940
1549,0,769,1053,774,344,2940
1550,802,277,697,699,284,1957
1551,0,32,119,39,61,251
1552,0,44,116,36,62,258
1553,0,4,20,23,0,47
1554,0,6,11,8,0,25
1555,0,311,730,754,327,2122
1556,805,654,1016,805,363,2838
1557,0,542,815,608,247,2212
1558,0,277,697,699,284,1957
1559,0,769,1053,774,344,2940
1560,0,247,620,638,266,1771
1561,0,260,509,434,170,1373
1562,0,486,687,523,233,1929
1563,0,297,1047,709,150,2203
1564,0,285,736,606,174,1801
1565,0,91,219,166,30,506
1566,915,94,178,169,22,463
1567,0,616,1590,1652,695,4553
1568,0,1462,1999,1434,638,5533
1569,0,297,1047,709,150,2203
1570,0,285,736,606,174,1801
1571,0,1931,3414,2766,1622,9733
1572,0,2633,4233,3321,1465,11652
1573,0,627,1023,353,510,2513
1574,0,299,1205,450,479,2433
1575,0,192,331,319,136,978
1576,0,616,1590,1652,695,4553
1577,0,1462,1999,1434,638,5533
1578,0,32,119,39,61,251
1579,0,44,116,36,62,258
1580,0,277,697,699,284,1957
1581,0,769,1053,774,344,2940
1582,802,769,1053,774,344,2940
1583,0,277,697,699,284,1957
1584,0,608,1119,1006,448,3181
1585,0,542,815,608,247,2212
1586,0,457,521,356,277,1611
1587,0,1698,3676,3077,1840,10291
1588,0,2419,3308,2618,1931,10276
1589,0,4,20,23,0,47
1590,0,6,11,8,0,25
1591,4892,374,2618,772,1097,4861
1592,0,1385,2043,401,1118,4947
1593,0,616,1590,1652,695,4553
1594,0,968,1292,919,427,3606
1595,0,494,707,515,212,1928
1596,0,491,1036,828,218,2573
1597,0,1947,3846,3134,1988,10915
1598,0,2387,3130,2484,1962,9963
1599,0,277,697,699,284,1957
1600,0,769,1053,774,344,2940
1601,0,677,1120,457,569,2823
1602,0,374,2618,772,1097,4861
1603,0,985,1449,388,723,3545
1604,0,297,1047,709,150,2203
1605,0,285,736,606,174,1801
1606,30615,5226,15182,7956,7369,35733
1607,0,389,966,1004,436,2795
1608,0,968,1292,919,427,3606
1609,0,1931,3414,2766,1622,9733
1610,0,2633,4233,3321,1465,11652
1611,0,297,1047,709,150,2203
1612,0,285,736,606,174,1801
1613,0,936,1456,1133,466,3991
1614,0,591,1066,942,593,3192
1615,0,27,70,71,25,193
1616,0,62,91,46,28,227
1617,0,591,1066,942,593,3192
1618,0,936,1456,1133,466,3991
1619,0,236,496,455,180,1367
1620,0,389,966,1004,436,2795
1621,0,1168,1613,1153,520,4454
1622,0,1954,3906,3099,1884,10843
1623,0,2387,3130,2484,1962,9963
1624,0,1402,2110,1785,872,6169
1625,0,1059,1998,1841,816,5714
1626,0,4,20,23,0,47
1627,0,591,1066,942,593,3192
1628,0,932,1436,1109,466,3943
1629,0,389,966,1004,436,2795
1630,0,968,1292,919,427,3606
1631,0,1931,3414,2766,1622,9733
1632,0,1411,2344,1993,1186,6934
1633,0,3609,5835,4604,2118,16166
1634,0,332,729,755,328,2144
1635,0,270,674,695,280,1919
1636,0,936,1456,1133,466,3991
1637,0,20,33,41,8,102
1638,915,91,219,166,30,506
1639,0,94,178,169,22,463
1640,0,5,13,13,5,36
1641,0,352,1939,766,790,3847
1642,5182,989,1454,391,723,3557
1643,0,1954,3906,3099,1884,10843
1644,5001,2387,3130,2484,1962,9963
1645,0,871,1475,1296,611,4253
1646,0,585,1055,934,593,3167
1647,0,1664,2753,2193,1046,7656
1648,3566,379,1124,996,487,2986
1649,0,768,1022,653,362,2805
1650,0,91,219,166,30,506
1651,0,94,178,169,22,463
1652,0,286,392,360,101,1139
1653,0,1402,2110,1785,872,6169
1654,3265,1193,2404,2296,933,6826
1655,0,297,1047,709,150,2203
1656,0,285,736,606,174,1801
1657,0,225,353,280,125,983
1658,0,192,331,319,136,978
1659,0,2654,4607,3848,2414,13523
1660,0,3204,6189,5644,2294,17331
1661,0,1482,2371,2058,763,6674
1662,0,2894,5299,4087,1684,13964
1663,0,608,1119,1006,448,3181
1664,0,542,815,608,247,2212
1665,0,3119,5634,4321,1939,15013
1666,0,3204,6189,5644,2294,17331
1667,0,2869,5566,4999,2162,15596
1668,0,3064,5293,4032,1692,14081
1669,0,2869,5566,4999,2162,15596
1670,0,3064,5293,4032,1692,14081
1671,0,2869,5566,4999,2162,15596
1672,0,1317,2528,2309,1029,7183
1673,7439,1482,2371,2058,763,6674
1674,0,539,1282,1296,568,3685
1675,0,1203,1642,1204,557,4606
1676,0,2478,4681,4069,1722,12950
1677,0,27,70,71,25,193
1678,0,97,130,86,43,356
1679,0,26,44,37,16,123
1680,0,358,519,422,179,1478
1681,0,3064,5293,4032,1692,14081
1682,0,182,427,416,166,1191
1683,0,823,993,780,453,3049
1684,0,2188,4469,4404,2069,13130
1685,0,2548,5205,4218,1780,13751
1686,0,608,1119,1006,448,3181
1687,0,542,815,608,247,2212
1688,0,2353,4399,4163,2094,13009
1689,13295,2548,5205,4218,1780,13751
1690,0,280,456,326,123,1185
1691,0,9,434,661,14,1118
1692,0,0,295,386,0,681
1693,0,141,333,264,109,847
1694,0,2869,5566,4999,2162,15596
1695,0,0,0,0,0,0
1696,5182,352,1942,772,792,3858
1697,0,989,1453,391,722,3555
1698,0,2,4,3,2,11
1699,0,5226,15182,7956,7369,35733
1700,0,141,333,264,109,847
1701,0,2923,4960,3768,1584,13235
1702,0,3119,5634,4321,1939,15013
1703,0,3204,6189,5644,2294,17331
1704,0,297,1047,709,150,2203
1705,0,285,736,606,174,1801
1706,0,329,589,566,238,1722
1707,0,225,353,280,125,983
1708,0,163,259,231,84,737
1709,13295,2353,4399,4163,2094,13009
1710,0,2548,5205,4218,1780,13751
1711,0,209,959,414,416,1998
1712,0,89,237,54,48,428
1713,5001,1954,3906,3099,1884,10843
1714,0,2387,3130,2484,1962,9963
1715,0,3119,5634,4321,1939,15013
1716,15160,3204,6189,5644,2294,17331
1717,0,227,624,648,259,1758
1718,0,494,707,515,212,1928
1719,0,6249,13529,6810,6455,33043
1720,0,136,258,247,102,743
1721,0,163,259,231,84,737
1722,0,232,928,591,219,1970
1723,0,989,1452,390,722,3553
1724,0,351,1942,772,792,3857
1725,0,232,927,591,219,1969
1726,0,209,959,414,416,1998
1727,0,989,1452,390,722,3553
1728,0,136,258,247,102,743
1729,0,163,259,231,84,737
1730,0,2638,5165,4684,2036,14523
1731,0,583,2868,1363,1011,5825
1732,0,2923,4960,3768,1584,13235
1733,7439,1317,2528,2309,1029,7183
1734,0,1482,2371,2058,763,6674
1735,3265,1688,2501,2145,973,7307
1736,0,1193,2404,2296,933,6826
1737,0,2353,4399,4163,2094,13009
1738,0,1954,3906,3099,1884,10843
1739,0,2995,3955,3093,2404,12447
1740,0,535,1512,1149,427,3623
1741,0,1077,1689,444,771,3981
1742,0,297,1047,709,150,2203
1743,0,285,736,606,174,1801
1744,0,0,0,0,0,0
1745,0,2478,4681,4069,1722,12950
1746,0,2158,4036,3181,1286,10661
1747,0,0,0,0,0,0
1748,0,31,74,74,26,205
1749,0,97,130,86,43,356
1750,0,227,624,648,259,1758
1751,0,494,707,515,212,1928
1752,0,2427,4463,3847,2780,13517
1753,0,2995,3955,3093,2404,12447
1754,0,297,1047,709,150,2203
1755,0,285,736,606,174,1801
1756,0,2638,5165,4684,2036,14523
1757,0,0,0,0,0,0
1783,0,6249,13529,6810,6455,33043
1759,0,0,0,0,0,0
1760,0,2923,4960,3768,1584,13235
1761,0,2923,4960,3768,1584,13235
1762,0,91,219,166,30,506
1763,0,1688,2501,2145,973,7307
1764,0,898,1768,1779,688,5133
1765,0,389,813,686,267,2155
1766,0,4993,14255,7364,7150,33762
1767,0,297,1196,468,465,2426
1768,0,136,258,247,102,743
1769,0,163,259,231,84,737
1770,0,2638,5165,4684,2036,14523
1772,0,379,1124,996,487,2986
1773,0,139,275,258,112,784
1774,0,853,1146,757,396,3152
1775,0,57,75,66,25,223
1776,0,608,1119,1006,448,3181
1777,0,522,810,599,247,2178
1778,0,261,833,934,116,2144
1779,0,2638,5165,4684,2036,14523
1780,0,0,0,0,0,0
1781,0,1077,1689,444,771,3981
1782,0,374,1909,949,595,3827
1784,0,261,523,440,116,1340
1785,0,2663,4437,3328,1468,11896
1786,0,191,337,275,119,922
1787,0,139,275,258,112,784
1788,0,1316,1788,1497,705,5306
1789,0,898,1768,1779,688,5133
1792,0,724,1156,855,420,3155
1793,0,2638,5180,4792,2036,14646
1794,0,457,1197,993,471,3118
1795,0,227,624,648,259,1758
1796,0,494,707,515,212,1928
1797,0,191,337,275,119,922
1798,0,139,275,258,112,784
1799,0,0,0,0,0,0
1800,0,2478,4681,4069,1722,12950
1801,0,136,258,247,102,743
1802,876,163,259,231,84,737
1803,15160,3119,5634,4321,1939,15013
1804,0,0,0,0,0,0
1805,0,463,932,814,299,2508
1806,2786,389,813,686,267,2155
1807,0,2158,4036,3181,1286,10661
1808,0,0,0,0,0,0
1811,876,136,258,247,102,743
1812,0,163,259,231,84,737
1813,0,5291,15450,7833,7614,36188
1814,0,1317,2528,2309,1029,7183
1815,0,1482,2371,2058,763,6674
1818,0,31,74,74,26,205
1819,0,384,817,778,355,2334
1820,0,491,736,525,221,1973
1821,0,520,667,551,218,1956
1822,0,5729,12862,6260,6238,31089
1825,0,583,850,287,438,2158
1826,0,1014,1506,708,550,3778
1827,0,227,624,648,259,1758
1828,0,0,0,0,0,0
1829,0,2972,5388,4583,1934,14877
1830,0,374,1909,949,595,3827
1831,0,520,667,551,218,1956
1832,0,2158,4036,3181,1286,10661
1833,0,227,624,648,259,1758
1834,0,56,78,73,30,237
1835,0,412,1186,1084,513,3195
1836,0,797,1068,684,366,2915
1837,0,136,258,247,102,743
1838,0,163,259,231,84,737
1839,0,374,1909,949,595,3827
1840,0,775,1708,768,682,3933
1841,0,1014,1506,708,550,3778
1844,0,566,2768,1430,839,5603
1845,0,1316,1788,1497,705,5306
1846,0,898,1768,1779,688,5133
1847,0,476,973,956,288,2693
1848,0,535,1512,1149,427,3623
1849,0,371,674,560,258,1863
1850,0,136,258,247,102,743
1851,0,491,835,713,338,2377
1852,0,503,928,802,358,2591
1853,0,491,835,713,338,2377
1854,0,2427,4463,3847,2780,13517
1855,0,2995,3955,3093,2404,12447
1856,0,647,842,515,359,2363
1857,0,422,748,287,222,1679
1858,0,5291,15450,7833,7614,36188
1859,0,476,973,956,288,2693
1860,0,535,1512,1149,427,3623
1861,0,32,119,39,61,251
1862,0,44,116,36,62,258
1863,0,566,2768,1430,839,5603
1864,0,55,84,95,30,264
1865,0,717,941,616,398,2672
1866,0,288,687,691,311,1977
1867,0,491,736,525,221,1973
1868,0,775,1708,768,682,3933
1869,0,503,928,802,358,2591
1870,0,491,835,713,338,2377
1875,34719,6504,14570,7029,6919,35022
1879,0,297,1047,709,150,2203
1880,0,503,928,802,358,2591
1881,0,772,1563,1313,510,4158
1883,0,476,973,956,288,2693
1884,9239,535,1512,1149,427,3623
1885,0,0,0,0,0,0
1886,0,422,748,287,222,1679
1887,0,796,1968,1504,505,4773
1888,0,772,1563,1313,510,4158
1889,0,391,1999,1022,582,3994
1890,0,0,0,0,0,0
1891,0,414,570,453,194,1631
1892,0,2990,5747,4976,2117,15830
1893,0,2385,4660,3830,1545,12420
1894,0,431,929,846,377,2583
1895,0,888,1338,1038,510,3774
1899,0,422,748,287,222,1679
1900,9239,476,973,956,288,2693
1901,0,535,1512,1149,427,3623
1902,0,391,1999,1022,582,3994
1903,0,300,953,604,326,2183
1904,0,717,941,616,398,2672
1905,0,386,1142,1047,497,3072
1906,0,797,1068,684,366,2915
1907,0,2,4,2,1,9
1908,0,2,4,3,2,11
1909,0,1317,2528,2309,1029,7183
1910,0,1482,2371,2058,763,6674
1911,0,2427,4463,3847,2780,13517
1912,0,2995,3955,3093,2404,12447
1913,0,796,1968,1504,505,4773
1914,7407,772,1563,1313,510,4158
1917,0,32,119,39,61,251
1918,0,44,116,36,62,258
1921,0,1316,1788,1497,705,5306
1922,0,898,1768,1779,688,5133
1923,0,2427,4463,3847,2780,13517
1924,0,2995,3955,3093,2404,12447
1925,0,644,1210,1126,410,3390
1926,0,1607,3760,3314,1305,9986
1927,2786,463,932,814,299,2508
1928,0,476,973,956,288,2693
1929,0,709,1991,1534,617,4851
1930,0,727,1387,1170,502,3786
1931,0,1316,1788,1497,705,5306
1932,0,644,1210,1126,410,3390
1933,0,1607,3760,3314,1305,9986
1936,0,0,0,0,0,0
1937,0,2990,5747,4976,2117,15830
1938,0,2526,4635,3700,1643,12504
1939,0,0,0,0,0,0
1940,0,60,71,52,25,208
1941,0,191,337,275,119,922
1942,0,98,241,229,103,671
1945,0,300,953,604,326,2183
1946,0,253,383,186,165,987
1947,0,463,558,429,232,1682
1948,0,764,1722,1561,596,4643
1949,0,888,1338,1038,510,3774
1950,0,386,1142,1047,497,3072
1951,0,797,1068,684,366,2915
1952,9147,422,748,287,222,1679
1954,0,1960,2999,2623,1114,8696
1955,10947,1607,3760,3314,1305,9986
1956,0,422,748,287,222,1679
1959,0,2990,5747,4976,2117,15830
1961,0,391,1999,1022,582,3994
1962,0,2526,4635,3700,1643,12504
1963,9147,391,1999,1022,582,3994
1964,0,169,248,182,81,680
1965,0,98,241,229,103,671
1966,482,169,248,182,81,680
1967,0,98,241,229,103,671
1968,0,806,1748,1513,602,4669
1969,0,727,1387,1170,502,3786
1970,0,2990,5747,4976,2117,15830
1971,0,2526,4635,3700,1643,12504
1972,0,0,0,0,0,0
1973,0,811,1589,1034,527,3961
1974,0,169,248,182,81,680
1975,482,98,241,229,103,671
1976,0,515,897,783,310,2505
1977,0,806,1748,1513,602,4669
1978,0,243,663,690,207,1803
1979,0,422,748,287,222,1679
1896,0,760,1395,1246,547,3948
1981,0,752,1352,1047,500,3651
1982,0,2290,4445,3804,1594,12133
1983,0,391,1999,1022,582,3994
1984,0,389,841,747,305,2282
1985,2998,371,807,763,293,2234
1986,0,391,1999,1022,582,3994
1987,0,2526,4635,3700,1643,12504
1988,0,59,93,73,24,249
1989,0,422,748,287,222,1679
1991,7407,796,1968,1504,505,4773
1994,0,772,1563,1313,510,4158
1995,0,2290,4445,3804,1594,12133
1996,0,391,1999,1022,582,3994
1998,0,288,687,691,311,1977
1999,0,491,736,525,221,1973
2000,10947,1960,2999,2623,1114,8696
2001,0,1607,3760,3314,1305,9986
2002,0,417,815,719,296,2247
2003,0,1833,3376,2726,1166,9101
2004,0,211,387,302,114,1014
2005,0,1960,2999,2623,1114,8696
2006,0,1465,3568,3124,1248,9405
2007,0,112,147,80,53,392
2008,0,945,1855,1311,623,4734
2116,0,328,554,446,192,1520
2009,0,737,2657,1703,821,5918
2010,0,246,413,357,150,1166
2011,0,1910,2886,2507,1064,8367
2012,0,1465,3568,3124,1248,9405
2013,0,796,1968,1504,505,4773
2014,0,1940,2957,2431,1073,8401
2015,0,1910,2886,2507,1064,8367
2016,0,919,2488,1879,829,6115
2017,0,1348,2715,2482,938,7483
2018,0,764,1722,1561,596,4643
2019,3053,888,1338,1038,510,3774
2020,0,890,2840,1927,887,6544
2021,0,1790,3070,2624,955,8439
2022,0,633,854,672,474,2633
2023,0,2427,4463,3847,2780,13517
2024,0,3137,4399,3477,2696,13709
2025,0,66,376,132,106,680
2026,0,253,383,186,165,987
2027,0,288,687,691,311,1977
2028,0,491,736,525,221,1973
2029,0,66,376,132,106,680
2030,0,253,383,186,165,987
2031,0,288,687,691,311,1977
2032,0,491,736,525,221,1973
2033,0,382,720,636,259,1997
2034,0,1908,3726,3167,1335,10136
2035,0,1748,3306,2773,1166,8993
2036,0,0,0,0,0,0
2037,0,32,119,39,61,251
2038,0,44,116,36,62,258
2039,0,903,1290,992,433,3618
2040,0,1317,2528,2309,1029,7183
2041,0,1411,2591,2374,922,7298
2042,0,1762,3423,2673,1012,8870
2043,0,223,289,243,145,900
2044,593,225,440,363,194,1222
2045,0,0,0,0,0,0
2046,0,1571,3004,2725,1083,8383
2047,0,515,1071,996,292,2874
2048,0,243,663,690,207,1803
2049,0,66,376,132,106,680
2050,1207,253,383,186,165,987
2051,593,223,289,243,145,900
2052,0,225,440,363,194,1222
2053,3053,764,1722,1561,596,4643
2054,0,888,1338,1038,510,3774
2055,0,0,0,0,0,0
2056,0,35,95,83,37,250
2057,0,1908,3726,3167,1335,10136
2058,0,386,1142,1047,497,3072
2059,0,797,1068,684,366,2915
2060,0,1366,2586,2137,907,6996
2061,0,0,0,0,0,0
2062,0,2749,4797,4004,3079,14629
2063,5751,3137,4399,3477,2696,13709
2066,1207,66,376,132,106,680
2067,0,253,383,186,165,987
2068,0,349,663,606,247,1865
2069,0,223,289,243,145,900
2070,0,125,323,289,76,813
2071,2998,414,989,828,359,2590
2072,0,123,223,243,53,642
2073,0,496,1130,1052,369,3047
2074,0,66,376,132,106,680
2075,0,253,383,186,165,987
2076,0,386,1142,1047,497,3072
2077,0,0,0,0,0,0
2078,0,649,1021,846,399,2915
2079,0,764,1722,1561,596,4643
2080,0,1085,1786,1501,708,5080
2082,0,1571,3004,2725,1083,8383
2083,0,1987,3863,3035,1206,10091
2085,0,0,0,0,0,0
2086,0,797,1068,684,366,2915
2087,0,125,323,289,76,813
2088,0,123,223,243,53,642
2089,0,537,1212,1072,412,3233
2090,3211,496,1130,1052,369,3047
2091,0,386,1142,1047,497,3072
2092,0,123,223,243,53,642
2093,0,125,323,289,76,813
2094,5751,2749,4797,4004,3079,14629
2095,0,3137,4399,3477,2696,13709
2096,0,123,223,243,53,642
2097,0,125,323,289,76,813
2098,0,125,323,289,76,813
2099,0,123,223,243,53,642
2100,0,515,1071,996,292,2874
2101,0,243,663,690,207,1803
2102,0,123,223,243,53,642
2103,0,125,323,289,76,813
2104,0,1627,2729,2369,1095,7820
2105,0,1411,2591,2374,922,7298
2106,0,288,687,691,311,1977
2107,0,491,736,525,221,1973
2108,0,386,1142,1047,497,3072
2109,0,797,1068,684,366,2915
2110,0,66,376,132,106,680
2111,0,253,383,186,165,987
2112,0,1090,2142,1926,800,5958
2113,0,1085,1786,1501,708,5080
2115,8443,1571,3004,2725,1083,8383
2117,0,1987,3863,3035,1206,10091
2119,0,515,1071,996,292,2874
2120,0,243,663,690,207,1803
2121,3211,537,1212,1072,412,3233
2122,0,496,1130,1052,369,3047
2125,0,386,1142,1047,497,3072
2126,7875,969,1348,1005,473,3795
2127,0,342,555,467,228,1592
2128,0,1627,2729,2369,1095,7820
2129,0,1411,2591,2374,922,7298
2130,0,169,248,182,81,680
2131,0,98,241,229,103,671
2132,0,537,1212,1072,412,3233
2133,0,496,1130,1052,369,3047
2134,0,169,248,182,81,680
2135,0,98,241,229,103,671
2136,0,169,248,182,81,680
2137,0,98,241,229,103,671
2138,0,76,140,118,63,397
2139,0,515,1071,996,292,2874
2140,3258,303,784,794,260,2141
2141,0,1090,2142,1926,800,5958
2142,0,1085,1786,1501,708,5080
2144,0,1571,3004,2725,1083,8383
2145,8443,1987,3863,3035,1206,10091
2147,0,32,119,39,61,251
2148,0,44,116,36,62,258
2149,0,1627,2729,2369,1095,7820
2150,0,1411,2591,2374,922,7298
2151,0,537,1212,1072,412,3233
2152,0,496,1130,1052,369,3047
2153,0,669,1500,1553,650,4372
2154,0,288,687,691,311,1977
2155,0,1399,2017,1477,639,5532
2156,0,2749,4797,4004,3079,14629
2157,0,3137,4399,3477,2696,13709
2158,0,1571,3004,2725,1083,8383
2159,0,1987,3863,3035,1206,10091
2160,0,66,376,132,106,680
2161,0,253,383,186,165,987
2162,7875,605,1462,1353,633,4053
2163,0,969,1348,1005,473,3795
2164,0,111,167,101,64,443
2165,0,537,1212,1072,412,3233
2166,0,507,1144,1063,374,3088
2167,0,1987,3863,3035,1206,10091
2170,0,1571,3004,2725,1083,8383
2171,0,605,1462,1353,633,4053
2172,0,969,1348,1005,473,3795
2173,0,1331,2491,2053,871,6746
2174,0,0,0,0,0,0
2175,0,0,0,0,0,0
2176,0,1908,3726,3167,1335,10136
2177,0,605,1462,1353,633,4053
2178,0,969,1348,1005,473,3795
2179,0,238,465,397,148,1248
2180,0,0,0,0,0,0
2181,0,1795,3435,3083,1233,9546
2182,0,1987,3863,3035,1206,10091
2183,0,238,465,397,148,1248
2184,0,1245,1235,825,414,3719
2185,0,2749,4797,4004,3079,14629
2186,0,2984,4765,4141,2929,14819
2187,0,618,1224,1083,419,3344
2188,0,507,1144,1063,374,3088
2189,0,169,248,182,81,680
2190,0,98,241,229,103,671
2191,0,957,2187,2244,961,6349
2192,0,1399,2017,1477,639,5532
2193,0,618,1224,1083,419,3344
2194,0,507,1144,1063,374,3088
2195,0,1627,2729,2369,1095,7820
2196,0,1411,2591,2374,922,7298
2197,0,1090,2142,1926,800,5958
2198,0,1089,1848,1468,705,5110
2199,0,872,1607,1489,623,4591
2200,0,169,248,182,81,680
2201,0,98,241,229,103,671
2202,0,66,376,132,106,680
2203,0,253,383,186,165,987
2204,3258,521,1067,989,301,2878
2205,0,303,784,794,260,2141
2206,0,957,2187,2244,961,6349
2207,0,1399,2017,1477,639,5532
2208,0,468,687,527,259,1941
2209,0,1143,2200,2177,964,6484
2210,0,2041,3655,3018,1255,9969
2212,0,1795,3435,3083,1233,9546
2213,0,2225,4328,3432,1354,11339
2216,0,1331,2491,2053,871,6746
2217,0,582,1061,1048,467,3158
2218,0,605,1462,1353,633,4053
2219,0,969,1348,1005,473,3795
2220,0,66,376,132,106,680
2221,0,253,383,186,165,987
2222,0,957,2187,2244,961,6349
2223,0,605,1462,1353,633,4053
2224,0,2792,3983,2968,1352,11095
2225,0,728,1596,1221,561,4106
2226,0,336,740,740,314,2130
2227,0,618,1224,1083,419,3344
2228,0,836,1557,1314,497,4204
1876,0,793,1470,1338,575,4176
2230,0,1162,1756,1506,676,5100
2231,0,730,1589,1440,626,4385
2232,0,234,577,472,220,1503
2233,0,463,558,429,232,1682
2234,0,751,1606,1496,608,4461
2235,0,836,1557,1314,497,4204
2236,0,155,387,382,156,1080
2237,0,521,1067,989,301,2878
2238,0,298,682,660,212,1852
2239,0,883,1868,1819,751,5321
2240,0,1089,1848,1468,705,5110
2241,0,1816,4335,4153,1833,12137
2242,12574,2792,3983,2968,1352,11095
2243,0,559,962,896,462,2879
2244,0,294,516,483,198,1491
2245,0,370,675,547,280,1872
2246,0,234,577,472,220,1503
2247,0,168,279,276,94,817
2248,0,625,794,649,332,2400
2249,0,679,1096,817,367,2959
2250,0,730,1589,1440,626,4385
2251,0,169,248,182,81,680
2252,0,98,241,229,103,671
2253,0,162,236,220,100,718
2254,0,168,279,276,94,817
2255,0,402,856,748,315,2321
2256,0,625,794,649,332,2400
2257,0,1083,1943,1563,669,5258
2258,0,872,1607,1489,623,4591
2259,0,2225,4328,3432,1354,11339
2262,8589,1795,3435,3083,1233,9546
2263,0,883,1868,1819,751,5321
2264,0,1089,1848,1468,705,5110
2265,0,883,1868,1819,751,5321
2266,0,1089,1848,1468,705,5110
2267,0,162,236,220,100,718
2268,0,168,279,276,94,817
2269,0,211,532,514,224,1481
2270,0,405,965,954,285,2609
2271,0,486,910,788,271,2455
2272,0,66,376,132,106,680
2273,0,751,1606,1496,608,4461
2274,0,905,1633,1328,540,4406
2275,0,247,578,575,261,1661
2276,0,169,248,182,81,680
2277,0,251,396,272,133,1052
2278,0,3451,5124,4000,3177,15752
2279,0,2984,4765,4141,2929,14819
2280,0,679,1096,817,367,2959
2281,0,730,1589,1440,626,4385
2282,0,883,1868,1819,751,5321
2283,0,1089,1848,1468,705,5110
2284,0,350,780,767,302,2199
2285,0,1083,1943,1563,669,5258
2286,0,527,833,728,324,2412
2287,33754,5291,15450,7833,7614,36188
2288,0,1446,2864,2574,1078,7962
2289,0,2041,3655,3018,1255,9969
2290,0,162,236,220,100,718
2291,0,168,279,276,94,817
2292,0,6504,14570,7029,6919,35022
2293,0,883,1868,1819,751,5321
2294,0,1089,1848,1468,705,5110
2295,0,899,1528,1152,563,4142
2296,0,728,1596,1221,561,4106
2297,0,3451,5124,4000,3177,15752
2298,0,2984,4765,4141,2929,14819
2299,0,334,656,554,263,1807
2300,0,1627,2729,2369,1095,7820
2301,0,1585,2948,2567,1055,8155
2302,0,899,1528,1152,563,4142
2303,0,728,1596,1221,561,4106
2304,12574,1816,4335,4153,1833,12137
2305,0,2792,3983,2968,1352,11095
2306,0,162,376,361,142,1041
2307,0,1938,3535,3096,1246,9815
2308,0,883,1868,1819,751,5321
2309,0,1089,1848,1468,705,5110
2310,0,391,934,914,374,2613
2311,8589,2225,4328,3432,1354,11339
2312,0,304,477,373,156,1310
2315,0,601,1163,957,382,3103
2316,1338,527,833,728,324,2412
2317,0,899,1528,1152,563,4142
2318,0,728,1596,1221,561,4106
2320,0,162,371,353,175,1061
2321,0,251,396,272,133,1052
2322,0,899,1528,1152,563,4142
2323,0,728,1596,1221,561,4106
2324,0,3451,5124,4000,3177,15752
2325,0,2984,4765,4141,2929,14819
2326,0,174,278,213,102,767
2327,0,162,236,220,100,718
2328,1227,342,567,549,193,1651
2331,0,633,1673,1456,591,4353
2332,0,905,1633,1328,540,4406
2335,0,1816,4335,4153,1833,12137
2336,0,679,1096,817,367,2959
2337,0,1363,1791,1274,610,5038
2338,0,832,1239,1007,422,3500
2341,0,883,1868,1819,751,5321
2342,0,1089,1848,1468,705,5110
2343,0,730,1589,1440,626,4385
2344,0,679,1096,817,367,2959
2345,0,679,1096,817,367,2959
2346,0,730,1589,1440,626,4385
2347,0,899,1528,1152,563,4142
2348,0,728,1596,1221,561,4106
2350,0,1938,3535,3096,1246,9815
2351,0,3451,5124,4000,3177,15752
2352,0,2984,4765,4141,2929,14819
2353,0,2168,4439,3640,1437,11684
2355,0,671,1776,1824,802,5073
2357,5934,1363,1791,1274,610,5038
2358,0,883,1868,1819,751,5321
2359,0,1089,1848,1468,705,5110
2360,0,162,371,353,175,1061
2361,0,251,396,272,133,1052
2362,0,739,990,905,419,3053
2363,0,402,856,748,315,2321
2364,0,519,711,644,280,2154
2365,1227,335,514,432,202,1483
2366,0,633,1673,1456,591,4353
2367,0,864,1578,1341,513,4296
2368,0,899,1528,1152,563,4142
2369,0,728,1596,1221,561,4106
2370,0,963,1346,997,504,3810
2371,0,1796,3056,2663,1243,8758
2372,10209,1749,3762,3454,1453,10418
2373,0,340,643,590,325,1898
2374,0,370,675,547,280,1872
2375,0,70,135,110,41,356
2376,0,883,1868,1819,751,5321
2377,0,1019,1716,1444,664,4843
2378,0,899,1528,1152,563,4142
2379,0,728,1596,1221,561,4106
2380,0,3451,5124,4000,3177,15752
2381,0,2984,4765,4141,2929,14819
2382,0,217,539,540,226,1522
2383,0,23,61,39,17,140
2384,0,2278,4001,3420,1391,11090
2385,0,2168,4439,3640,1437,11684
2386,0,193,492,506,206,1397
2387,0,1446,2864,2574,1078,7962
2388,0,2041,3655,3018,1255,9969
2389,0,899,1528,1152,563,4142
2390,0,728,1596,1221,561,4106
2391,0,1446,2864,2574,1078,7962
2392,0,2041,3655,3018,1255,9969
2393,0,419,721,637,301,2078
2394,0,519,711,644,280,2154
2395,0,162,371,353,175,1061
2396,0,251,396,272,133,1052
2397,0,0,0,0,0,0
2398,0,2278,4001,3420,1391,11090
2399,0,2338,4870,4107,1626,12941
2400,0,0,0,0,0,0
2401,0,899,1528,1152,563,4142
2402,0,728,1596,1221,561,4106
2403,0,899,1528,1152,563,4142
2404,0,389,1089,610,345,2433
2405,0,723,1259,1111,507,3600
2406,1338,601,1163,957,382,3103
2407,0,527,833,728,324,2412
2408,0,445,1170,1204,393,3212
2409,0,486,910,788,271,2455
2410,0,3451,5124,4000,3177,15752
2411,0,2783,4407,3766,2505,13461
2412,0,2503,4352,3734,2172,12761
2413,0,586,1566,1351,573,4076
2414,0,864,1578,1341,513,4296
2415,10209,2462,3848,3193,1543,11046
2416,0,3111,5392,4324,2596,15423
2417,0,3210,6269,5591,2808,17878
2418,0,3186,4696,3772,3105,14759
2419,0,2223,4300,3674,1939,12136
2420,0,2579,4124,3495,2436,12634
2421,0,1446,2864,2574,1078,7962
2422,0,2041,3655,3018,1255,9969
2423,0,2278,4001,3420,1391,11090
2424,0,2338,4870,4107,1626,12941
2425,0,601,1163,957,382,3103
2426,0,527,833,728,324,2412
2427,0,0,0,0,0,0
2428,0,2503,4352,3734,2172,12761
2429,0,496,1114,1018,451,3079
2430,0,832,1239,1007,422,3500
2431,0,2666,4595,3703,2384,13348
2432,0,0,0,0,0,0
2433,0,586,1566,1351,573,4076
2434,0,864,1578,1341,513,4296
2435,0,534,918,595,368,2415
2436,0,389,1089,610,345,2433
2437,0,2825,5116,4383,2469,14793
2438,5934,671,1776,1824,802,5073
2439,0,1363,1791,1274,610,5038
2440,0,445,1170,1204,393,3212
2441,0,2567,4422,3588,1820,12397
2442,0,399,803,737,240,2179
2443,0,534,918,595,368,2415
2444,0,389,1089,610,345,2433
2445,0,3111,5392,4324,2596,15423
2446,0,749,1361,1057,486,3653
2447,1583,723,1259,1111,507,3600
2448,0,518,1256,1261,394,3429
2449,0,2197,4094,3403,1829,11523
2450,0,401,886,845,261,2393
2451,0,1054,1916,1736,824,5530
2452,0,496,1114,1018,451,3079
2453,0,2043,3522,2956,1197,9718
2454,0,1839,3442,2680,1167,9128
2455,0,534,918,595,368,2415
2456,0,389,1089,610,345,2433
2457,0,391,949,838,253,2431
2458,0,1024,2126,1723,758,5631
2459,0,2043,3522,2956,1197,9718
2460,0,211,242,195,99,747
2461,0,419,721,637,301,2078
2462,0,308,468,449,181,1406
2463,0,1272,2555,2073,813,6713
2464,0,1491,2822,2456,979,7748
2465,0,2407,4228,3479,1787,11901
2466,0,2069,3659,3191,1275,10194
2467,0,1241,3019,2497,927,7684
2468,0,2198,3887,3250,1671,11006
2469,0,1491,2822,2456,979,7748
2470,0,1272,2555,2073,813,6713
2471,0,340,643,590,325,1898
2472,0,370,675,547,280,1872
2473,0,3097,5842,4919,2528,16386
2474,0,1169,1911,1675,576,5331
2475,0,2825,5116,4383,2469,14793
2476,0,3111,5392,4324,2596,15423
2477,0,1241,3019,2497,927,7684
2478,0,2933,5480,4599,2372,15384
2479,0,1097,1851,1610,699,5257
2480,0,2198,3887,3250,1671,11006
2481,0,3295,5738,4860,2370,16263
2483,0,1416,3075,2561,1012,8064
2484,0,2043,3522,2956,1197,9718
2485,11716,3295,5738,4860,2370,16263
2487,0,2933,5480,4599,2372,15384
2488,0,3295,5738,4860,2370,16263
2489,0,182,294,191,111,778
2491,11716,2933,5480,4599,2372,15384
2492,0,1491,2822,2456,979,7748
2493,5598,1272,2555,2073,813,6713
2494,0,671,1776,1824,802,5073
2495,0,1363,1791,1274,610,5038
2497,0,2933,5480,4599,2372,15384
2498,0,3145,5378,4502,2242,15267
2500,0,516,847,696,327,2386
2501,0,332,654,550,239,1775
2502,0,2709,5153,4272,2237,14371
2503,0,823,1740,1705,706,4974
2504,0,1019,1716,1444,664,4843
2505,0,2825,5116,4383,2469,14793
2506,1583,749,1361,1057,486,3653
2507,0,723,1259,1111,507,3600
2508,11716,3145,5378,4502,2242,15267
2510,0,2825,5116,4383,2469,14793
2511,0,0,0,0,0,0
2513,11716,2709,5153,4272,2237,14371
2514,0,495,1133,1099,306,3033
2515,0,401,886,845,261,2393
2517,0,2709,5153,4272,2237,14371
2518,0,446,797,621,211,2075
2519,0,2666,4595,3703,2384,13348
2520,0,322,764,650,298,2034
2521,0,823,1740,1705,706,4974
2522,0,1019,1716,1444,664,4843
2523,0,343,583,463,196,1585
2524,0,1272,2555,2073,813,6713
2525,0,1169,2275,2027,799,6270
2526,0,586,1566,1351,573,4076
2527,0,864,1578,1341,513,4296
2528,0,3145,5378,4502,2242,15267
2529,0,132,175,137,61,505
2530,0,823,1740,1705,706,4974
2531,0,1019,1716,1444,664,4843
2532,0,1030,1367,950,478,3825
2533,0,499,1314,1395,592,3800
2534,0,4209,6631,5270,3024,19134
2535,0,3210,6269,5591,2808,17878
2536,0,2233,3542,2845,1484,10104
2538,0,601,1163,957,382,3103
2539,0,527,833,728,324,2412
2540,0,1044,2011,1794,819,5668
2541,0,1691,3331,2578,1446,9046
2542,0,1227,2195,1937,930,6289
2543,0,534,918,595,368,2415
2544,0,389,1089,610,345,2433
2545,0,323,443,436,192,1394
2546,0,308,468,449,181,1406
2547,0,333,424,323,133,1213
2548,0,172,462,429,210,1273
2549,0,2233,3542,2845,1484,10104
2551,0,336,761,731,299,2127
2552,0,2144,3459,2764,1458,9825
2553,0,416,649,459,210,1734
2555,0,1691,3331,2578,1446,9046
2556,0,2233,3542,2845,1484,10104
2558,0,2233,3542,2845,1484,10104
2559,0,150,286,213,102,751
2560,0,2539,4117,3471,2591,12718
2561,0,2579,4124,3495,2436,12634
2562,0,2233,3542,2845,1484,10104
2564,0,2259,3824,3231,1610,10924
2567,0,1691,3331,2578,1446,9046
2568,0,83,209,116,83,491
2569,0,1989,3697,2770,1542,9998
2571,0,1691,3331,2578,1446,9046
2573,0,1691,3331,2578,1446,9046
2574,0,310,650,558,231,1749
2575,0,238,369,294,127,1028
2576,0,1656,3257,2428,1415,8756
2577,0,749,1361,1057,486,3653
2578,0,723,1259,1111,507,3600
2580,0,1989,3697,2770,1542,9998
2581,0,1416,3075,2561,1012,8064
2582,5598,1491,2822,2456,979,7748
2583,0,1095,1871,1621,499,5086
2584,0,993,1907,1733,769,5402
2585,0,1113,2186,1773,685,5757
2586,0,1254,2005,1657,914,5830
2587,0,1169,2275,2027,799,6270
2588,0,1113,2186,1773,685,5757
2590,0,1169,1911,1675,576,5331
2591,0,749,1361,1057,486,3653
2592,0,723,1259,1111,507,3600
2593,0,1077,2657,2176,772,6682
2595,0,1113,2186,1773,685,5757
2596,0,1169,2275,2027,799,6270
2597,0,2259,3824,3231,1610,10924
2599,0,1069,1876,1623,841,5409
2600,3555,1254,2005,1657,914,5830
2601,0,6504,14570,7029,6919,35022
2602,0,54,421,123,172,770
2603,0,229,312,54,171,766
2605,8084,1989,3697,2770,1542,9998
2606,0,172,462,429,210,1273
2607,0,333,424,323,133,1213
2608,0,499,1314,1395,592,3800
2609,0,1030,1367,950,478,3825
2610,0,323,443,436,192,1394
2611,0,308,468,449,181,1406
2612,0,5291,15450,7833,7614,36188
2613,0,823,1740,1705,706,4974
2614,0,1019,1716,1444,664,4843
2615,0,601,1163,957,382,3103
2616,0,527,833,728,324,2412
2617,0,1536,2974,2642,1204,8356
2618,0,1839,3442,2680,1167,9128
2619,8084,2259,3824,3231,1610,10924
2622,0,1989,3697,2770,1542,9998
2623,0,586,1566,1351,573,4076
2624,0,864,1578,1341,513,4296
2625,0,601,1163,957,382,3103
2626,0,527,833,728,324,2412
2628,0,1169,1911,1675,576,5331
2629,0,1077,2657,2176,772,6682
2631,0,172,462,429,210,1273
2632,0,333,424,323,133,1213
2633,0,495,1133,1099,306,3033
2634,0,93,197,173,36,499
2635,0,438,957,910,302,2607
2636,0,54,421,123,172,770
2637,0,229,312,54,171,766
2638,0,323,443,436,192,1394
2639,1627,308,468,449,181,1406
2640,0,2259,3824,3231,1610,10924
2641,0,586,1566,1351,573,4076
2642,0,579,1163,1030,364,3136
2643,0,1424,2779,2667,1186,8056
2644,0,749,1361,1057,486,3653
2645,0,1079,1565,1223,538,4405
2646,0,172,462,429,210,1273
2647,0,333,424,323,133,1213
2648,0,249,624,590,219,1682
2649,0,2326,4259,3288,1701,11574
2650,0,93,265,219,65,642
2651,0,534,918,595,368,2415
2652,0,389,1089,610,345,2433
2653,0,105,213,193,47,558
2654,0,93,197,173,36,499
2655,0,6504,14570,7029,6919,35022
2656,0,172,462,429,210,1273
2657,0,333,424,323,133,1213
2658,3555,1069,1876,1623,841,5409
2659,0,1254,2005,1657,914,5830
2660,0,105,213,193,47,558
2661,0,93,197,173,36,499
2662,0,686,1690,1609,479,4464
2663,0,1095,1871,1621,499,5086
2664,0,883,1653,1324,473,4333
2665,0,2539,4117,3471,2591,12718
2666,0,2390,3862,3299,2422,11973
2667,0,160,311,276,148,895
2668,0,1069,1876,1623,841,5409
2669,0,1501,2494,2064,1121,7180
2670,0,105,213,193,47,558
2671,0,93,197,173,36,499
2672,0,2310,4352,3682,1816,12160
2674,0,340,643,590,325,1898
2675,0,370,675,547,280,1872
2676,0,6504,14570,7029,6919,35022
2678,0,2326,4259,3288,1701,11574
2679,0,1229,2187,1899,988,6303
2680,0,1501,2494,2064,1121,7180
2681,0,5291,15450,7833,7614,36188
2682,0,378,870,810,365,2423
2683,0,601,1163,957,382,3103
2684,0,895,1401,1115,519,3930
2686,0,1169,1911,1675,576,5331
2687,0,1077,2657,2176,772,6682
2689,0,6504,14570,7029,6919,35022
2690,0,499,1314,1395,592,3800
2691,0,1030,1367,950,478,3825
2692,0,1229,2187,1899,988,6303
2693,0,1501,2494,2064,1121,7180
2694,0,1229,2187,1899,988,6303
2695,0,1501,2494,2064,1121,7180
2696,0,6504,14570,7029,6919,35022
2697,0,2310,4352,3682,1816,12160
2700,9484,2326,4259,3288,1701,11574
2701,0,799,1689,1486,647,4621
2702,0,895,1401,1115,519,3930
2703,0,105,213,193,47,558
2704,0,93,197,173,36,499
2705,0,4209,6631,5270,3024,19134
2706,0,3210,6269,5591,2808,17878
2707,0,186,719,460,313,1678
2708,0,451,635,309,271,1666
2709,0,3076,8950,3852,4364,20242
2710,0,3428,5620,3178,2555,14781
2711,0,2488,3837,3250,2447,12022
2712,0,2390,3862,3299,2422,11973
2713,0,1229,2187,1899,988,6303
2714,0,799,1689,1486,647,4621
2715,0,2061,3191,2620,1446,9318
2716,0,105,213,193,47,558
2717,0,93,197,173,36,499
2718,0,599,956,796,305,2656
2719,0,686,1690,1609,479,4464
2720,8392,665,1297,1169,296,3427
2721,0,519,1187,1143,335,3184
2722,0,438,957,910,302,2607
2723,0,451,635,309,271,1666
2724,0,186,719,460,313,1678
2725,0,186,719,460,313,1678
2726,0,451,635,309,271,1666
2727,0,2488,3837,3250,2447,12022
2728,0,2390,3862,3299,2422,11973
2729,0,534,918,595,368,2415
2730,0,389,1089,610,345,2433
2731,0,54,421,123,172,770
2732,769,229,312,54,171,766
2733,0,186,719,460,313,1678
2734,0,451,635,309,271,1666
2736,0,1169,1911,1675,576,5331
2737,0,1077,2657,2176,772,6682
2739,0,186,719,460,313,1678
2740,0,451,635,309,271,1666
2741,0,534,918,595,368,2415
2742,0,389,1089,610,345,2433
2743,0,202,389,307,138,1036
2744,0,105,213,193,47,558
2745,0,287,617,472,181,1557
2746,0,389,1089,610,345,2433
2747,0,162,371,353,175,1061
2748,0,451,635,309,271,1666
2749,769,54,421,123,172,770
2750,0,534,918,595,368,2415
2751,0,0,0,0,0,0
2752,0,2,4,2,1,9
2753,0,2,4,3,2,11
2754,0,1122,2209,1900,896,6127
2755,0,1227,2195,1937,930,6289
2756,0,534,918,595,368,2415
2757,0,0,0,0,0,0
2758,0,389,1089,610,345,2433
2759,0,534,918,595,368,2415
2760,0,1693,3171,2826,1442,9132
2761,0,2061,3191,2620,1446,9318
2762,0,228,656,660,151,1695
2763,0,519,1187,1143,335,3184
2764,0,219,528,532,155,1434
2765,0,307,603,500,185,1595
2766,0,287,617,472,181,1557
2767,0,534,918,595,368,2415
2768,0,5291,15450,7833,7614,36188
2769,0,4209,6631,5270,3024,19134
2770,0,3210,6269,5591,2808,17878
2771,0,534,918,595,368,2415
2772,0,389,1089,610,345,2433
2773,9484,2310,4352,3682,1816,12160
2775,0,823,1740,1705,706,4974
2776,0,1019,1716,1444,664,4843
2778,0,2326,4259,3288,1701,11574
2779,0,499,1314,1395,592,3800
2780,0,1030,1367,950,478,3825
2781,0,100,287,295,79,761
2782,0,93,265,219,65,642
2783,0,700,1520,1555,679,4454
2784,0,1079,1565,1223,538,4405
2785,0,307,603,500,185,1595
2786,0,287,617,472,181,1557
2787,0,534,918,595,368,2415
2788,0,389,1089,610,345,2433
2789,0,4209,6631,5270,3024,19134
2790,0,823,1740,1705,706,4974
2791,0,1738,3375,3019,1620,9752
2792,3207,1141,2207,1927,720,5995
2793,0,499,1314,1395,592,3800
2794,0,1030,1367,950,478,3825
2795,0,186,719,460,313,1678
2796,0,451,635,309,271,1666
2797,0,1536,2974,2642,1204,8356
2798,0,172,462,429,210,1273
2799,0,1325,1688,1400,773,5186
2800,0,1323,3062,2365,834,7584
2801,0,340,643,590,325,1898
2802,0,534,918,595,368,2415
2803,0,719,1699,1094,601,4113
2804,0,307,603,500,185,1595
2805,0,271,549,403,179,1402
2806,0,1191,1981,1788,567,5527
2807,0,1077,2657,2176,772,6682
2808,0,313,605,544,175,1637
2809,0,297,580,515,201,1593
2810,8392,400,1083,1047,212,2742
2811,0,665,1297,1169,296,3427
2812,0,700,1520,1555,679,4454
2813,0,1079,1565,1223,538,4405
2814,0,835,1497,1122,671,4125
2815,0,719,1699,1094,601,4113
2816,0,2596,3686,2881,1871,11034
2817,0,1738,3375,3019,1620,9752
2818,0,977,1677,1514,846,5014
2819,0,1325,1688,1400,773,5186
2820,0,186,719,460,313,1678
2821,0,798,1144,525,467,2934
2822,0,99,676,208,98,1081
2823,0,264,1349,647,390,2650
2824,0,798,1144,525,467,2934
2825,0,260,517,475,170,1422
2826,0,297,580,515,201,1593
2827,0,2,4,2,1,9
2828,0,2,4,3,2,11
2829,0,194,674,834,143,1845
2830,0,219,528,532,155,1434
2831,0,835,1497,1122,671,4125
2832,0,719,1699,1094,601,4113
2833,0,1001,1515,1432,602,4550
2834,0,2310,4352,3682,1816,12160
2835,0,694,1099,1005,400,3198
2836,0,246,108,104,229,687
2837,0,1122,2209,1900,896,6127
2838,0,1603,2279,2003,1123,7008
2839,0,700,1520,1555,679,4454
2840,0,1079,1565,1223,538,4405
2841,0,320,482,437,184,1423
2842,0,2700,4875,3856,1918,13349
2843,0,260,517,475,170,1422
2844,0,297,580,515,201,1593
2845,0,1693,3171,2826,1442,9132
2846,0,2061,3191,2620,1446,9318
2847,0,400,1083,1047,212,2742
2848,0,665,1297,1169,296,3427
2849,0,264,1349,647,390,2650
2850,0,835,1497,1122,671,4125
2851,0,1032,1517,1214,686,4449
2852,0,100,287,295,79,761
2853,0,93,265,219,65,642
2854,0,260,517,475,170,1422
2855,0,297,580,515,201,1593
2856,3207,1087,2282,2005,728,6102
2857,0,1141,2207,1927,720,5995
2858,0,1693,3171,2826,1442,9132
2859,0,2061,3191,2620,1446,9318
2860,0,615,1518,1363,679,4175
2861,3781,1032,1517,1214,686,4449
2863,0,1191,1981,1788,567,5527
2864,0,700,1520,1555,679,4454
2865,0,1079,1565,1223,538,4405
2866,0,1156,2776,2357,799,7088
2868,1627,323,443,436,192,1394
2869,0,308,468,449,181,1406
2870,0,393,727,684,292,2096
2871,0,260,517,475,170,1422
2872,2962,516,940,788,332,2576
2873,0,100,287,295,79,761
2874,0,93,265,219,65,642
2875,0,126,262,237,124,749
2876,0,194,674,834,143,1845
2877,0,97,272,301,47,717
2878,0,3076,8950,3852,4364,20242
2879,0,1693,3171,2826,1442,9132
2880,0,2061,3191,2620,1446,9318
2881,0,50,423,622,62,1157
2882,0,97,272,301,47,717
2883,0,977,1677,1514,846,5014
2884,0,1325,1688,1400,773,5186
2885,0,1368,2316,2003,1126,6813
2886,0,1603,2279,2003,1123,7008
2887,2962,443,844,782,324,2393
2888,0,516,940,788,332,2576
2889,0,368,555,237,216,1376
2890,0,99,676,208,98,1081
2891,0,2732,4918,4219,2073,13942
2893,0,400,1083,1047,212,2742
2894,0,665,1297,1169,296,3427
2896,0,2700,4875,3856,1918,13349
2898,0,1191,1981,1788,567,5527
2899,0,1156,2776,2357,799,7088
2901,0,453,710,598,373,2134
2902,0,2488,3837,3250,2447,12022
2903,0,2498,3994,3330,2440,12262
2904,0,499,1314,1395,592,3800
2905,0,1030,1367,950,478,3825
2906,0,443,844,782,324,2393
2907,0,516,940,788,332,2576
2908,0,100,287,295,79,761
2909,0,93,265,219,65,642
2910,0,5549,8696,4704,4033,22982
2911,0,32,119,39,61,251
2912,0,44,116,36,62,258
2913,0,50,423,622,62,1157
2914,0,97,272,301,47,717
2915,0,2732,4918,4219,2073,13942
2916,0,428,575,399,203,1605
2917,0,977,1677,1514,846,5014
2918,0,1325,1688,1400,773,5186
2919,0,13,494,488,13,1008
2920,0,100,287,295,79,761
2921,0,118,806,627,76,1627
2922,0,870,1219,903,411,3403
2923,0,315,721,662,269,1967
2924,0,2450,4780,3802,1909,12941
2925,0,2121,3076,1526,1478,8201
2926,0,368,555,237,216,1376
2927,0,99,676,208,98,1081
2929,0,1191,1981,1788,567,5527
2930,0,1156,2776,2357,799,7088
2932,0,1368,2316,2003,1126,6813
2933,0,443,844,782,324,2393
2934,0,2024,3034,2626,1391,9075
2936,6988,1191,1981,1788,567,5527
2937,0,2990,7864,3187,4004,18045
2938,0,2121,3076,1526,1478,8201
2939,0,2553,4004,3367,2557,12481
2940,0,2505,3977,3317,2443,12242
2941,0,6,18,13,10,47
2942,0,368,555,237,216,1376
2943,0,99,676,208,98,1081
2953,26162,5549,8696,4704,4033,22982
2945,0,1156,2776,2357,799,7088
2947,0,3076,8950,3852,4364,20242
2948,0,293,530,462,159,1444
2949,0,400,1083,1047,212,2742
2950,0,959,1848,1615,465,4887
2951,0,323,443,436,192,1394
2952,0,308,468,449,181,1406
2954,0,5111,10940,4713,5482,26246
2955,0,2555,3986,3355,2565,12461
2956,0,2505,3977,3317,2443,12242
2957,0,24,31,26,11,92
2958,0,114,781,783,92,1770
2959,0,94,775,600,65,1534
2960,3781,615,1518,1363,679,4175
2961,0,1032,1517,1214,686,4449
2962,0,618,3428,1665,1434,7145
2963,0,2596,3686,2881,1871,11034
2964,0,1738,3375,3019,1620,9752
2965,0,5111,10940,4713,5482,26246
2966,0,50,423,622,62,1157
2967,0,12,19,12,6,49
2968,0,85,284,307,41,717
2969,0,2300,7586,4645,3610,18141
2970,0,618,3428,1665,1434,7145
2971,0,1087,2282,2005,728,6102
2972,0,1141,2207,1927,720,5995
2973,0,2918,11015,6311,5045,25289
2974,0,2918,11015,6311,5045,25289
2975,0,2555,3986,3355,2565,12461
2976,0,2505,3977,3317,2443,12242
2977,0,323,443,436,192,1394
2979,0,308,468,449,181,1406
2980,0,1717,2975,2620,1386,8698
2981,0,2024,3034,2626,1391,9075
2982,0,2918,11015,6311,5045,25289
2983,0,226,460,389,171,1246
2984,0,0,0,0,0,0
2985,0,1428,2462,2157,732,6779
2986,0,682,1598,1492,364,4136
2987,0,959,1848,1615,465,4887
2988,6988,1156,2776,2357,799,7088
2989,0,226,460,389,171,1246
2990,0,5111,10940,4713,5482,26246
2991,0,2845,4773,3956,2007,13581
2993,0,1693,3171,2826,1442,9132
2994,0,1560,2500,1944,996,7000
2995,0,504,1056,954,450,2964
2997,0,2450,4780,3802,1909,12941
2998,0,700,1520,1555,679,4454
2999,0,1079,1565,1223,538,4405
3000,0,1087,2282,2005,728,6102
3001,0,1141,2207,1927,720,5995
3002,0,499,1314,1395,592,3800
3003,0,1030,1367,950,478,3825
3004,0,682,1598,1492,364,4136
3005,0,959,1848,1615,465,4887
3006,0,922,1496,1225,560,4203
3007,0,977,1677,1514,846,5014
3008,5528,1623,2425,2018,1108,7174
3009,0,3693,12379,5517,5799,27388
3010,0,5111,10940,4713,5482,26246
3011,0,2596,3686,2881,1871,11034
3012,0,1738,3375,3019,1620,9752
3013,0,700,1520,1555,679,4454
3014,0,1079,1565,1223,538,4405
3015,0,45,435,628,52,1160
3016,0,85,284,307,41,717
3018,0,1428,2462,2157,732,6779
3019,0,1250,2514,2294,1128,7186
3020,6468,1560,2500,1944,996,7000
3021,0,1381,3236,2747,970,8334
3023,0,2845,4773,3956,2007,13581
3025,0,700,1520,1555,679,4454
3026,0,1079,1565,1223,538,4405
3027,0,368,555,237,216,1376
3028,0,99,676,208,98,1081
3029,0,1717,2975,2620,1386,8698
3030,0,2024,3034,2626,1391,9075
3031,0,2555,3986,3355,2565,12461
3032,0,2505,3977,3317,2443,12242
3034,0,2450,4780,3802,1909,12941
3035,0,1208,2643,2320,875,7046
3036,14451,1323,3062,2365,834,7584
3037,0,100,747,752,79,1678
3038,0,94,775,600,65,1534
3039,0,615,1518,1363,679,4175
3040,0,1032,1517,1214,686,4449
3041,0,5111,10940,4713,5482,26246
3042,0,499,1314,1395,592,3800
3043,0,1030,1367,950,478,3825
3044,0,100,747,752,79,1678
3045,0,94,775,600,65,1534
3046,0,2596,3686,2881,1871,11034
3047,0,1738,3375,3019,1620,9752
3048,0,682,1598,1492,364,4136
3049,0,959,1848,1615,465,4887
3050,0,5111,10940,4713,5482,26246
3051,0,2845,4773,3956,2007,13581
3052,0,1616,3603,2785,1469,9473
3053,0,835,1177,1017,440,3469
3054,0,2596,3686,2881,1871,11034
3055,6486,1645,2662,2278,1344,7929
3056,0,740,1522,1435,728,4425
3057,0,323,443,436,192,1394
3058,0,188,304,281,107,880
3059,0,121,164,168,74,527
3060,0,5111,10940,4713,5482,26246
3061,0,700,1520,1555,679,4454
3062,0,1079,1565,1223,538,4405
3064,0,1428,2462,2157,732,6779
3065,0,1087,2282,2005,728,6102
3066,0,1141,2207,1927,720,5995
3067,0,1717,2975,2620,1386,8698
3068,0,2024,3034,2626,1391,9075
3069,0,5549,8696,4704,4033,22982
3070,0,1381,3236,2747,970,8334
3072,0,100,747,752,79,1678
3073,0,94,775,600,65,1534
3074,0,615,1518,1363,679,4175
3075,0,1032,1517,1214,686,4449
3076,0,5111,10940,4713,5482,26246
3077,0,1418,2457,2168,960,7003
3078,5528,1480,2394,2056,1136,7066
3079,0,1895,2982,2356,1344,8577
3080,25396,2918,11015,6311,5045,25289
3081,0,499,1314,1395,592,3800
3082,0,700,1520,1555,679,4454
3083,0,545,959,783,339,2626
3084,0,2417,3445,2645,1212,9719
3085,0,615,1518,1363,679,4175
3086,0,1032,1517,1214,686,4449
3087,0,3693,12379,5517,5799,27388
3088,0,1087,2282,2005,728,6102
3089,0,1141,2207,1927,720,5995
3090,0,2555,3986,3355,2565,12461
3091,6132,2505,3977,3317,2443,12242
3092,0,2845,4773,3956,2007,13581
3094,0,297,689,640,264,1890
3095,0,553,801,600,359,2313
3096,0,604,1001,932,453,2990
3098,0,1616,3603,2785,1469,9473
3099,0,189,254,230,101,774
3100,0,188,304,281,107,880
3101,0,906,1167,472,583,3128
3102,0,4643,7529,4232,3450,19854
3103,0,317,830,723,414,2284
3104,0,125,285,318,126,854
3105,0,798,1106,838,456,3198
3106,0,682,1598,1492,364,4136
3107,0,959,1848,1615,465,4887
3108,0,100,747,752,79,1678
3109,4061,94,775,600,65,1534
3110,14451,1208,2643,2320,875,7046
3111,0,548,971,1437,352,3308
3112,0,775,2091,1484,482,4832
3113,6486,2051,2875,2329,1585,8840
3114,6486,1645,2662,2278,1344,7929
3115,0,2727,10599,5918,4852,24096
3116,0,2845,4773,3956,2007,13581
3117,0,829,1445,1235,576,4085
3118,0,1087,2282,2005,728,6102
3119,0,313,763,693,144,1913
3120,0,1616,3603,2785,1469,9473
3121,0,5111,10940,4713,5482,26246
3122,0,2,4,2,1,9
3123,0,2,4,3,2,11
3124,0,134,189,206,90,619
3125,0,121,164,168,74,527
3126,0,1785,2845,2452,1384,8466
3127,0,1895,2982,2356,1344,8577
3128,0,682,1598,1492,364,4136
3129,0,959,1848,1615,465,4887
3130,29428,3693,12379,5517,5799,27388
3131,0,297,689,640,264,1890
3132,0,245,305,238,97,885
3133,0,604,1001,932,453,2990
3134,0,1785,2845,2452,1384,8466
3135,0,1895,2982,2356,1344,8577
3137,0,1428,2462,2157,732,6779
3138,0,1381,3236,2747,970,8334
3140,0,45,435,628,52,1160
3141,0,85,284,307,41,717
3142,4061,100,747,752,79,1678
3143,0,199,1014,822,154,2189
3144,0,149,246,204,92,691
3145,0,340,773,775,133,2021
3146,0,313,763,693,144,1913
3147,0,442,1114,1041,540,3137
3148,0,798,1106,838,456,3198
3149,0,249,993,956,171,2369
3150,0,199,1014,822,154,2189
3151,0,682,1598,1492,364,4136
3152,0,959,1848,1615,465,4887
3153,0,214,434,453,191,1292
3154,0,543,993,878,361,2775
3155,0,437,667,547,298,1949
3156,6132,2555,3986,3355,2565,12461
3157,0,2505,3977,3317,2443,12242
3158,6468,1250,2514,2294,1128,7186
3159,0,1560,2500,1944,996,7000
3160,0,340,773,775,133,2021
3161,0,313,763,693,144,1913
3163,0,1428,2462,2157,732,6779
3164,0,1785,2845,2452,1384,8466
3165,0,1895,2982,2356,1344,8577
3166,0,1381,3236,2747,970,8334
3168,0,442,1114,1041,540,3137
3169,0,798,1106,838,456,3198
3170,0,1853,3874,2969,1578,10274
3171,0,1717,2975,2620,1386,8698
3172,0,2024,3034,2626,1391,9075
3173,0,742,1643,1596,678,4659
3174,0,682,1598,1492,364,4136
3175,0,1591,2558,1990,716,6855
3176,0,5482,9086,5472,4192,24232
3177,0,1938,3606,3485,1424,10453
3178,0,840,1556,1240,742,4378
3179,0,1428,2462,2157,732,6779
3180,0,1250,2514,2294,1128,7186
3181,0,1560,2500,1944,996,7000
3182,0,2727,10599,5918,4852,24096
3183,0,569,1044,1114,421,3148
3184,0,5482,9086,5472,4192,24232
3185,0,45,435,628,52,1160
3186,3925,85,284,307,41,717
3187,0,3296,11642,7031,5273,27242
3188,0,442,1114,1041,540,3137
3189,0,798,1106,838,456,3198
3190,0,237,271,184,108,800
3191,0,5245,8815,5288,4084,23432
3192,0,1785,2845,2452,1384,8466
3193,0,1662,2522,2051,1197,7432
3194,0,345,784,551,241,1921
3195,0,943,2236,2200,724,6103
3196,0,1591,2558,1990,716,6855
3197,0,3296,11642,7031,5273,27242
3199,0,1428,2462,2157,732,6779
3200,0,1381,3236,2747,970,8334
3202,0,257,639,588,252,1736
3203,0,437,667,547,298,1949
3204,0,1250,2514,2294,1128,7186
3205,0,1560,2500,1944,996,7000
3206,0,253,1271,674,550,2748
3207,0,1600,2602,2295,1028,7525
3208,0,1515,2324,2017,1171,7027
3209,0,1662,2522,2051,1197,7432
3210,0,2778,5162,4724,2166,14830
3211,6486,2051,2875,2329,1585,8840
3212,0,1645,2662,2278,1344,7929
3213,0,134,189,206,90,619
3214,0,121,164,168,74,527
3215,0,1515,2324,2017,1171,7027
3216,0,1662,2522,2051,1197,7432
3217,0,2051,2875,2329,1585,8840
3218,0,1645,2662,2278,1344,7929
3219,0,1515,2324,2017,1171,7027
3220,0,1662,2522,2051,1197,7432
3221,0,2,4,2,1,9
3222,0,2,4,3,2,11
3223,0,1503,3334,2767,1455,9059
3224,0,2417,3445,2645,1212,9719
3225,3925,45,435,628,52,1160
3226,0,85,284,307,41,717
3227,0,442,1114,1041,540,3137
3228,0,798,1106,838,456,3198
3229,0,663,1683,2093,536,4975
3230,0,775,2091,1484,482,4832
3231,0,943,2236,2200,724,6103
3232,0,1591,2558,1990,716,6855
3233,0,340,773,775,133,2021
3234,0,126,365,373,78,942
3235,891,187,397,320,66,970
3236,0,663,1683,2093,536,4975
3237,0,775,2091,1484,482,4832
3238,0,1515,2324,2017,1171,7027
3239,0,1662,2522,2051,1197,7432
3240,0,198,418,417,72,1105
3241,0,126,365,373,78,942
3242,891,142,355,358,61,916
3243,0,187,397,320,66,970
3244,0,368,555,237,216,1376
3245,0,99,676,208,98,1081
3246,0,1717,2975,2620,1386,8698
3247,0,2024,3034,2626,1391,9075
3248,0,663,1683,2093,536,4975
3249,0,775,2091,1484,482,4832
3250,0,442,1114,1041,540,3137
3251,0,798,1106,838,456,3198
3252,0,142,355,358,61,916
3253,0,187,397,320,66,970
3254,29878,6080,9992,6305,4524,26901
3255,0,943,2236,2200,724,6103
3256,0,1591,2558,1990,716,6855
3258,0,1428,2462,2157,732,6779
3259,0,1381,3236,2747,970,8334
3261,0,142,355,358,61,916
3262,0,187,397,320,66,970
3263,0,3043,10371,6358,4723,24495
3264,0,1142,1832,1687,808,5469
3265,0,442,1114,1041,540,3137
3266,0,798,1106,838,456,3198
3267,0,442,1114,1041,540,3137
3268,0,798,1106,838,456,3198
3269,0,1428,2462,2157,732,6779
3271,0,442,1114,1041,540,3137
3272,0,798,1106,838,456,3198
3273,5780,442,1114,1041,540,3137
3274,0,1212,1881,1568,747,5408
3275,0,510,826,730,280,2346
3276,0,1381,3236,2747,970,8334
3277,0,442,1114,1041,540,3137
3278,0,798,1106,838,456,3198
3279,0,668,1117,909,402,3096
3280,0,2051,2875,2329,1585,8840
3281,0,2193,3808,3225,1758,10984
3282,5780,798,1106,838,456,3198
3283,0,442,1114,1041,540,3137
3284,0,1503,3334,2767,1455,9059
3285,0,952,1941,1771,819,5483
3286,0,2696,3710,2829,1376,10611
3287,0,383,845,681,307,2216
3288,0,345,784,551,241,1921
3289,0,2705,3982,3224,1981,11892
3290,0,2193,3808,3225,1758,10984
3291,0,1522,3660,3155,1692,10029
3292,0,2696,3710,2829,1376,10611
3293,0,1515,2324,2017,1171,7027
3294,5930,1662,2522,2051,1197,7432
3295,0,2705,3982,3224,1981,11892
3296,0,2193,3808,3225,1758,10984
3297,0,1250,2514,2294,1128,7186
3298,0,1560,2500,1944,996,7000
3299,0,134,356,383,118,991
3300,0,198,418,417,72,1105
3301,2789,302,776,732,189,1999
3302,0,2210,4118,3611,1745,11684
3303,0,2743,4435,3983,1836,12997
3304,0,2555,3986,3355,2565,12461
3305,0,2505,3977,3317,2443,12242
3306,0,189,254,230,101,774
3307,0,188,304,281,107,880
3308,0,257,639,588,252,1736
3309,0,437,667,547,298,1949
3310,0,45,435,628,52,1160
3311,0,85,284,307,41,717
3312,0,191,416,393,193,1193
3313,0,2210,4118,3611,1745,11684
3314,0,2705,3982,3224,1981,11892
3315,0,2193,3808,3225,1758,10984
3316,0,2743,4435,3983,1836,12997
3317,0,45,435,628,52,1160
3318,0,85,284,307,41,717
3319,0,1250,2514,2294,1128,7186
3320,0,1560,2500,1944,996,7000
3321,5930,1515,2324,2017,1171,7027
3322,0,1662,2522,2051,1197,7432
3323,0,663,1683,2093,536,4975
3324,0,1522,3660,3155,1692,10029
3325,0,3084,5330,3878,1709,14001
3326,0,387,471,372,149,1379
3327,0,414,775,729,291,2209
3328,0,510,826,730,280,2346
3329,0,1250,2514,2294,1128,7186
3330,0,1560,2500,1944,996,7000
3331,0,2705,3982,3224,1981,11892
3332,0,2193,3808,3225,1758,10984
3334,0,1428,2462,2157,732,6779
3335,0,1381,3236,2747,970,8334
3337,0,142,355,358,61,916
3338,0,187,397,320,66,970
3339,0,134,189,206,90,619
3340,0,121,164,168,74,527
3341,0,1717,2975,2620,1386,8698
3342,0,2024,3034,2626,1391,9075
3343,0,2024,4889,4688,2040,13641
3344,0,3084,5330,3878,1709,14001
3345,0,249,993,956,171,2369
3346,0,7,17,16,7,47
3347,0,192,997,806,148,2143
3348,0,943,2236,2200,724,6103
3349,0,1591,2558,1990,716,6855
3350,0,6080,9992,6305,4524,26901
3351,0,45,435,628,52,1160
3352,0,85,284,307,41,717
3354,0,1428,2462,2157,732,6779
3355,0,1381,3236,2747,970,8334
3357,0,142,355,358,61,916
3358,0,187,397,320,66,970
3359,0,1250,2514,2294,1128,7186
3360,0,2705,3982,3224,1981,11892
3361,0,1218,1991,1573,717,5499
3362,0,2122,3542,2922,1769,10355
3363,29828,4186,12203,8045,5531,29965
3364,0,1515,2324,2017,1171,7027
3365,0,1662,2522,2051,1197,7432
3366,0,2401,4534,4004,1938,12877
3367,0,134,189,206,90,619
3368,0,0,0,0,0,0
3369,0,134,189,206,90,619
3370,0,2608,4245,3777,1745,12375
3371,0,887,1025,722,338,2972
3372,0,161,455,497,188,1301
3373,0,252,719,746,302,2019
3374,0,1710,2958,2604,1379,8651
3375,0,249,993,956,171,2369
3376,0,807,2256,1887,661,5611
3377,0,223,469,305,146,1143
3378,0,765,1616,1392,651,4424
3379,0,2066,3674,3121,1396,10257
3381,0,1428,2462,2157,732,6779
3382,0,1381,3236,2747,970,8334
3384,0,2024,4889,4688,2040,13641
3385,0,3084,5330,3878,1709,14001
3386,0,383,845,681,307,2216
3387,4412,345,784,551,241,1921
3388,0,32,119,39,61,251
3389,0,44,116,36,62,258
3390,0,223,469,305,141,1138
3391,0,597,1341,1109,483,3530
3392,6136,765,1616,1392,651,4424
3393,0,414,775,729,291,2209
3394,0,510,826,730,280,2346
3395,0,1515,2324,2017,1171,7027
3396,0,1662,2522,2051,1197,7432
3397,0,2351,4742,4336,1918,13347
3398,0,82,234,237,63,616
3399,0,1818,2932,2429,933,8112
3400,0,32,119,39,61,251
3401,0,44,116,36,62,258
3402,0,2663,5016,4230,1879,13788
3403,0,391,950,895,395,2631
3404,0,1381,3236,2747,970,8334
3405,0,472,705,509,264,1950
3406,0,564,678,467,229,1938
3407,0,252,719,746,302,2019
3408,0,142,355,358,61,916
3409,0,580,1208,973,282,3043
3410,0,283,707,760,230,1980
3411,2789,332,775,800,189,2096
3412,0,394,811,653,216,2074
3413,0,276,716,750,191,1933
3414,0,943,2236,2200,724,6103
3415,0,1591,2558,1990,716,6855
3416,0,7,19,19,8,53
3417,0,2,4,2,1,9
3418,0,11,17,12,5,45
3419,0,283,707,760,230,1980
3420,0,394,811,653,216,2074
3421,0,283,707,760,230,1980
3422,0,394,811,653,216,2074
3423,0,2280,4370,3836,1864,12350
3424,0,2024,4889,4688,2040,13641
3425,0,3084,5330,3878,1709,14001
3426,0,2608,4245,3777,1745,12375
3427,0,340,444,311,197,1292
3428,0,2555,3986,3355,2565,12461
3429,0,2166,3533,3006,2247,10952
3430,0,426,1062,1118,292,2898
3431,1622,580,1208,973,282,3043
3432,0,283,707,760,230,1980
3433,0,394,811,653,216,2074
3434,6136,820,1810,1413,624,4667
3435,0,765,1616,1392,651,4424
3436,0,383,845,681,307,2216
3437,0,345,784,551,241,1921
3438,4412,383,845,681,307,2216
3439,0,345,784,551,241,1921
3440,0,1047,2020,1732,755,5554
3441,0,1218,1991,1573,717,5499
3442,0,345,784,551,241,1921
3443,0,383,845,681,307,2216
3444,0,383,845,681,307,2216
3445,0,345,784,551,241,1921
3446,0,394,811,653,216,2074
3447,0,283,707,760,230,1980
3448,0,2351,4742,4336,1918,13347
3449,0,1515,2324,2017,1171,7027
3450,0,1662,2522,2051,1197,7432
3451,0,257,639,588,252,1736
3452,0,437,667,547,298,1949
3453,1622,426,1062,1118,292,2898
3454,0,580,1208,973,282,3043
3455,0,2663,5016,4230,1879,13788
3456,0,820,1810,1413,624,4667
3457,0,765,1616,1392,651,4424
3458,0,2494,3700,3111,2087,11392
3459,8158,2122,3542,2922,1769,10355
3460,0,33,40,21,18,112
3461,0,189,254,230,101,774
3462,0,154,264,260,89,767
3463,0,564,678,467,229,1938
3464,0,383,845,681,307,2216
3465,0,459,1210,1034,438,3141
3466,0,6,16,15,7,44
3467,0,11,17,12,5,45
3468,0,414,775,729,291,2209
3469,0,510,826,730,280,2346
3470,0,426,1062,1118,292,2898
3471,0,580,1208,973,282,3043
3472,0,426,1062,1118,292,2898
3473,0,580,1208,973,282,3043
3474,11650,2608,4245,3777,1745,12375
3476,0,1818,2932,2429,933,8112
3477,0,1514,3689,3201,1243,9647
3479,0,580,1208,973,282,3043
3480,0,426,1062,1118,292,2898
3481,0,2351,4742,4336,1918,13347
3483,0,426,1062,1118,292,2898
3484,0,580,1208,973,282,3043
3485,0,580,1208,973,282,3043
3486,0,426,1062,1118,292,2898
3487,0,6,16,15,7,44
3488,0,11,17,12,5,45
3489,11650,2280,4370,3836,1864,12350
3492,0,2663,5016,4230,1879,13788
3494,0,2608,4245,3777,1745,12375
3495,0,1047,2020,1732,755,5554
3496,0,1218,1991,1573,717,5499
3497,0,820,1810,1413,624,4667
3498,0,765,1616,1392,651,4424
3499,0,45,435,628,52,1160
3500,0,85,284,307,41,717
3501,0,1515,2324,2017,1171,7027
3502,0,1662,2522,2051,1197,7432
3503,0,415,819,711,176,2121
3504,0,276,716,750,191,1933
3505,0,2024,4889,4688,2040,13641
3506,0,808,1230,885,431,3354
3507,0,3543,6539,4912,2147,17141
3508,0,1047,2020,1732,755,5554
3509,0,1218,1991,1573,717,5499
3510,0,2351,4742,4336,1918,13347
3511,0,467,906,850,369,2592
3512,0,533,865,761,359,2518
3513,0,3543,6539,4912,2147,17141
3514,8158,2494,3700,3111,2087,11392
3515,0,2122,3542,2922,1769,10355
3516,0,2832,6118,5573,2471,16994
3517,0,0,0,0,0,0
3518,0,3130,5921,5080,2247,16378
3519,0,943,2236,2200,724,6103
3520,0,1591,2558,1990,716,6855
3521,0,2375,3558,2972,2308,11213
3522,0,2166,3533,3006,2247,10952
3523,0,257,639,588,252,1736
3524,0,437,667,547,298,1949
3525,0,2884,5607,5097,2276,15864
3527,0,1818,2932,2429,933,8112
3528,0,1514,3689,3201,1243,9647
3530,14088,3130,5921,5080,2247,16378
3531,0,228,359,367,143,1097
3532,0,2494,3700,3111,2087,11392
3533,0,2048,3438,2804,1717,10007
3534,0,360,718,623,259,1960
3535,0,1047,2020,1732,755,5554
3536,0,907,1358,1027,490,3782
3537,0,2280,4370,3836,1864,12350
3538,0,2608,4245,3777,1745,12375
3539,0,64,151,153,25,393
3540,0,2206,3677,3034,1235,10152
3541,0,1514,3689,3201,1243,9647
3542,0,452,896,758,327,2433
3543,0,429,1189,1055,394,3067
3544,0,2832,6118,5573,2471,16994
3545,0,0,0,0,0,0
3546,0,6,16,15,7,44
3547,0,11,17,12,5,45
3548,0,679,1396,1237,519,3831
3549,0,907,1358,1027,490,3782
3550,0,554,1090,906,370,2920
3551,0,429,1189,1055,394,3067
3552,0,0,0,0,0,0
3553,0,3543,6539,4912,2147,17141
3554,0,820,1810,1413,624,4667
3555,0,765,1616,1392,651,4424
3556,0,1515,2324,2017,1171,7027
3557,0,1662,2522,2051,1197,7432
3558,0,181,241,216,96,734
3559,0,154,264,260,89,767
3560,0,196,284,226,115,821
3561,0,943,2236,2200,724,6103
3562,7206,1672,2751,2141,784,7348
3563,0,45,435,628,52,1160
3564,0,85,284,307,41,717
3565,14088,2884,5607,5097,2276,15864
3566,0,268,564,518,240,1590
3567,0,2417,3582,3049,2045,11093
3568,0,2048,3438,2804,1717,10007
3569,0,927,2136,1827,603,5493
3570,0,871,1883,1748,576,5078
3571,0,894,1554,1359,648,4455
3572,0,679,1396,1237,519,3831
3573,0,1754,2818,2268,1090,7930
3574,0,347,744,696,318,2105
3575,0,129,198,163,74,564
3576,0,3398,6351,5329,2379,17457
3577,0,2206,3677,3034,1235,10152
3578,0,871,1883,1748,576,5078
3579,0,927,2136,1827,603,5493
3580,0,1777,4533,3955,1570,11835
3581,0,415,819,711,176,2121
3582,0,276,716,750,191,1933
3583,0,1524,2865,2518,1136,8043
3584,0,1754,2818,2268,1090,7930
3585,0,3023,5973,5452,2442,16890
3586,0,433,699,502,322,1956
3587,0,5647,9293,5803,4201,24944
3588,0,2513,4580,3888,1702,12683
3589,0,885,1771,1440,677,4773
3590,0,554,1090,906,370,2920
3591,0,396,1111,973,397,2877
3592,0,40,92,94,2,228
3593,0,415,819,711,176,2121
3594,0,1524,2865,2518,1136,8043
3595,0,1820,3121,2655,1158,8754
3596,0,927,2136,1827,603,5493
3597,4978,871,1883,1748,576,5078
3598,0,2375,3558,2972,2308,11213
3599,0,871,1883,1748,576,5078
3600,0,1445,3243,2756,999,8443
3601,0,2464,3571,2994,2475,11504
3602,0,181,241,216,96,734
3603,0,154,264,260,89,767
3604,0,2280,4370,3836,1864,12350
3606,0,4186,12203,8045,5531,29965
3607,0,1777,4533,3955,1570,11835
3608,0,2206,3677,3034,1235,10152
3609,0,1318,2237,1661,669,5885
3610,0,1860,2848,2497,831,8036
3611,4988,1276,3484,3162,1246,9168
3612,0,257,639,588,252,1736
3613,0,437,667,547,298,1949
3615,0,2608,4245,3777,1745,12375
3616,0,417,630,475,195,1717
3617,4978,927,2136,1827,603,5493
3618,0,596,1549,1542,429,4116
3619,0,198,450,435,185,1268
3620,0,820,1810,1413,624,4667
3621,0,570,1208,1021,468,3267
3622,0,1515,2324,2017,1171,7027
3623,0,1662,2522,2051,1197,7432
3624,0,45,435,628,52,1160
3625,4988,2247,3052,2520,900,8719
3626,0,1303,3966,3734,1248,10251
3627,0,65,220,126,4,415
3628,0,823,1249,847,298,3217
3629,0,2832,6118,5573,2471,16994
3630,0,206,687,616,293,1802
3631,0,2417,3582,3049,2045,11093
3632,0,2048,3438,2804,1717,10007
3633,0,501,1002,828,352,2683
3634,0,396,1111,973,397,2877
3635,0,340,531,378,116,1365
3636,0,3410,6695,5150,2323,17578
3637,0,60,102,90,23,275
3638,0,40,92,94,2,228
3639,0,414,775,729,291,2209
3640,0,510,826,730,280,2346
3641,0,501,1002,828,352,2683
3642,0,396,1111,973,397,2877
3643,0,2293,3465,2949,912,9619
3644,0,908,2608,2391,942,6849
3645,0,1349,2947,2643,875,7814
3646,0,1777,4533,3955,1570,11835
3647,0,1041,1377,1215,247,3880
3648,0,501,1002,828,352,2683
3649,0,396,1111,973,397,2877
3650,0,1731,3272,2866,1189,9058
3651,0,1820,3121,2655,1158,8754
3652,0,525,695,431,234,1885
3653,0,257,639,588,252,1736
3654,0,203,602,445,329,1579
3655,0,6,16,15,7,44
3656,0,11,17,12,5,45
3657,0,426,1062,1118,292,2898
3658,0,842,1771,1463,418,4494
3659,0,170,495,451,138,1254
3660,0,1515,2324,2017,1171,7027
3661,0,1662,2522,2051,1197,7432
3662,0,557,1356,1143,476,3532
3663,0,570,1208,1021,468,3267
3664,0,33,69,66,25,193
3665,0,501,1002,828,352,2683
3666,0,369,1049,912,373,2703
3667,0,1793,3760,3539,1476,10568
3668,0,2146,6553,3535,2805,15039
3669,7206,1057,2393,2300,798,6548
3670,0,1672,2751,2141,784,7348
3671,0,261,569,517,136,1483
3672,0,170,495,451,138,1254
3673,0,5884,9625,6135,4249,25893
3674,0,1910,3303,2780,875,8868
3675,0,1349,2947,2643,875,7814
3676,0,2417,3582,3049,2045,11093
3677,0,2048,3438,2804,1717,10007
3678,0,4,11,9,3,27
3679,0,450,894,756,330,2430
3680,3968,365,1038,902,369,2674
3681,0,3160,6292,5525,2452,17429
3682,0,1731,3272,2866,1189,9058
3683,0,1820,3121,2655,1158,8754
3684,11858,3410,6695,5150,2323,17578
3685,0,414,775,729,291,2209
3686,0,510,826,730,280,2346
3687,0,761,1515,1342,575,4193
3688,0,1515,2324,2017,1171,7027
3689,0,2176,3343,2643,1533,9695
3690,0,67,160,138,58,423
3691,0,557,1356,1143,476,3532
3692,0,649,1340,1131,504,3624
3693,0,60,102,90,23,275
3694,0,40,92,94,2,228
3695,0,6,16,15,7,44
3696,0,11,17,12,5,45
3697,0,1731,3272,2866,1189,9058
3698,0,1820,3121,2655,1158,8754
3699,0,2590,5274,4950,2120,14934
3700,0,448,1347,1463,530,3788
3701,0,3755,5799,3015,2819,15388
3702,0,3343,5773,4636,2174,15926
3703,0,2417,3582,3049,2045,11093
3704,0,2048,3438,2804,1717,10007
3705,0,2202,3738,3141,2677,11758
3706,0,734,1181,1118,1236,4269
3707,0,1791,2940,2436,1239,8406
3708,0,6095,10640,7266,4731,28732
3709,0,280,564,542,268,1654
3710,0,378,567,246,220,1411
3711,0,204,816,269,144,1433
3712,11858,3160,6292,5525,2452,17429
3713,0,60,102,90,23,275
3714,0,40,92,94,2,228
3715,0,1793,3719,3490,1476,10478
3716,0,0,41,48,0,89
3717,0,3768,10905,7038,4974,26685
3718,0,767,1350,1266,598,3981
3719,0,1057,2393,2300,798,6548
3720,0,1672,2751,2141,784,7348
3721,0,181,241,216,96,734
3722,0,2280,4370,3836,1864,12350
3723,0,154,264,260,89,767
3724,0,414,775,729,291,2209
3725,0,510,826,730,280,2346
3726,0,2879,5087,4129,1766,13861
3727,0,530,1608,1021,557,3716
3728,0,0,0,0,0,0
3729,0,2763,4509,4037,1834,13143
3730,0,583,1243,1043,1185,4054
3731,0,734,1181,1118,1236,4269
3732,0,3755,5799,3015,2819,15388
3733,0,261,569,517,136,1483
3734,0,170,495,451,138,1254
3735,0,1910,3303,2780,875,8868
4038,0,50,105,100,45,300
3736,6513,1301,2844,2545,831,7521
3737,0,1367,2573,2034,976,6950
3738,0,253,710,474,257,1694
3739,0,427,824,802,354,2407
3740,0,1731,3272,2866,1189,9058
3741,0,2251,3730,3015,1418,10414
3742,0,6,440,589,4,1039
3743,0,583,1243,1043,1185,4054
3744,0,625,691,549,1167,3032
3745,0,113,161,134,73,481
3746,3968,442,885,748,327,2402
3747,0,365,1038,902,369,2674
3748,0,4535,12255,8304,5572,30666
3749,0,253,710,474,257,1694
3750,0,2879,5087,4129,1766,13861
3751,0,6,16,15,7,44
3752,0,11,17,12,5,45
3753,0,831,1193,748,472,3244
3754,0,5264,9447,6518,4259,25488
3755,0,368,555,237,216,1376
3756,0,103,689,222,102,1116
3757,0,14,17,14,5,50
3758,0,783,2318,1494,814,5409
3759,0,440,899,825,1110,3274
3760,0,625,691,549,1167,3032
3761,0,6,16,15,7,44
3762,0,11,17,12,5,45
3763,0,2146,6553,3535,2805,15039
3764,0,3038,6621,6413,2650,18722
3765,0,622,1511,1276,532,3941
3766,0,649,1340,1131,504,3624
3767,0,4535,12255,8304,5572,30666
3768,0,258,650,470,310,1688
3769,0,3085,5123,4166,1864,14238
3770,0,3755,5799,3015,2819,15388
3771,0,383,655,369,318,1725
3772,0,204,816,269,144,1433
3773,0,2146,6553,3535,2805,15039
3774,0,314,485,290,197,1286
3775,0,203,602,445,329,1579
3776,0,60,102,90,23,275
3986,0,58,97,77,36,268
3777,0,90,197,194,47,528
3778,0,1057,2393,2300,798,6548
3779,0,1824,2852,2189,1029,7894
3780,0,501,1117,1022,217,2857
3781,0,1619,3243,2460,1233,8555
3782,0,622,1511,1276,532,3941
3783,0,649,1340,1131,504,3624
3784,0,3755,5799,3015,2819,15388
3785,12145,853,6656,1937,2717,12163
3786,0,1365,2193,1992,819,6369
3787,0,414,775,729,291,2209
3788,0,814,1423,1294,556,4087
3789,12145,853,6656,1937,2717,12163
3790,0,0,0,0,0,0
3791,0,2879,5087,4129,1766,13861
3792,0,442,885,748,327,2402
3793,0,365,1038,902,369,2674
3794,0,1926,3085,2745,1531,9287
3795,0,2176,3343,2643,1533,9695
3796,0,2460,4611,4052,1960,13083
3797,0,0,0,0,0,0
3798,0,1999,3756,3358,1449,10562
3799,0,2251,3730,3015,1418,10414
3800,0,6,16,15,7,44
3801,0,11,17,12,5,45
3802,12145,3614,4937,867,2708,12126
3803,0,0,0,0,0,0
3804,0,2763,4509,4037,1834,13143
3805,0,344,806,682,243,2075
3806,0,2417,3582,3049,2045,11093
3807,0,2385,4184,3385,1939,11893
3808,0,3614,4937,867,2708,12126
3809,0,2130,3825,3120,1429,10504
3810,0,1619,3243,2460,1233,8555
3811,0,440,899,825,1110,3274
3812,0,625,691,549,1167,3032
3813,0,261,569,517,136,1483
3814,0,170,495,451,138,1254
3815,0,6,16,15,7,44
3816,0,11,17,12,5,45
3818,6513,1855,3208,2705,839,8607
3839,0,440,899,825,1110,3274
3819,0,196,412,362,103,1073
3841,0,1730,3123,2732,1895,9480
3820,0,622,1511,1276,532,3941
3821,0,442,885,748,327,2402
3822,0,207,456,383,177,1223
3823,0,2929,5086,3897,1977,13889
3824,0,749,1262,1009,337,3357
3825,0,1679,3044,2658,1492,8873
3826,0,1791,2940,2436,1239,8406
3827,0,1999,3756,3358,1449,10562
3828,0,2251,3730,3015,1418,10414
3829,0,1036,1489,1281,606,4412
3830,0,2460,4611,4052,1960,13083
3831,0,325,684,606,242,1857
3832,0,6,16,15,7,44
3833,0,11,17,12,5,45
3834,0,800,1261,777,548,3386
3835,0,420,648,413,283,1764
3836,11599,1170,1911,1422,620,5123
3837,0,611,839,761,362,2573
3838,0,2476,4354,3882,1714,12426
3817,0,279,477,374,135,1265
3840,0,160,410,332,115,1017
3842,0,209,499,456,148,1312
3843,0,1926,3085,2745,1531,9287
3844,0,2176,3343,2643,1533,9695
3845,0,257,473,374,163,1267
3846,0,207,456,383,177,1223
3848,0,117,199,167,59,542
3849,0,90,197,194,47,528
3850,0,2929,8871,5030,3619,20449
3851,11599,820,1982,1682,686,5170
3852,0,0,0,0,0,0
3853,0,1133,2481,2335,429,6378
3854,0,1824,2852,2189,1029,7894
3855,0,1999,3756,3358,1449,10562
3856,0,2251,3730,3015,1418,10414
3857,0,3755,5799,3015,2819,15388
3858,0,1220,1909,1191,831,5151
3859,0,2134,3696,3198,1835,10863
3860,0,1730,3123,2732,1895,9480
3861,0,0,0,0,0,0
3862,0,1170,1911,1422,620,5123
3863,0,2751,4381,3723,2286,13141
3864,0,2385,4184,3385,1939,11893
3865,0,98,689,203,288,1278
3866,1293,366,540,106,295,1307
3867,0,257,473,374,163,1267
3868,0,207,456,383,177,1223
3869,0,1999,3756,3358,1449,10562
3870,0,2251,3730,3015,1418,10414
3871,0,1679,3044,2658,1492,8873
3872,4889,1791,2940,2436,1239,8406
3873,0,6149,11218,7959,4937,30263
3874,0,451,614,455,236,1756
3875,0,261,569,517,136,1483
3876,0,413,1106,1034,419,2972
3877,0,820,1982,1682,686,5170
3878,0,0,0,0,0,0
3879,0,0,0,0,0,0
3880,0,2929,8871,5030,3619,20449
3881,0,7,17,18,7,49
3882,0,14,17,14,5,50
3883,0,6,16,15,7,44
3884,0,11,17,12,5,45
3885,0,2134,3696,3198,1835,10863
3886,0,1730,3123,2732,1895,9480
3887,0,0,0,0,0,0
3888,0,1170,1911,1422,620,5123
3889,0,4974,7708,4206,3650,20538
3890,0,0,0,0,0,0
3891,1293,98,689,203,288,1278
3892,0,332,497,100,272,1201
3893,0,34,42,6,23,105
3894,0,1133,2481,2335,429,6378
3895,0,1210,1837,1499,574,5120
3896,0,615,1015,690,455,2775
3897,0,4276,11605,7834,5262,28977
3898,0,1485,1901,1699,731,5816
3899,0,2414,4361,3690,1835,12300
3900,0,370,385,217,111,1083
3901,0,1999,3756,3358,1449,10562
3902,6450,2251,3730,3015,1418,10414
3903,0,776,1397,1296,547,4016
3904,0,1242,1753,1431,606,5032
3905,0,1718,3499,3149,1448,9814
3906,0,32,119,39,61,251
3907,0,314,485,290,197,1286
3908,0,0,0,0,0,0
3909,0,246,715,480,389,1830
3910,0,577,1131,1035,831,3574
3911,0,501,1117,1022,217,2857
3912,0,418,1299,1006,557,3280
3913,0,2271,5271,5147,2052,14741
3817,0,172,270,232,131,805
3914,0,89,235,246,78,648
3915,0,58,92,78,36,264
3916,0,1133,2481,2335,429,6378
3917,0,0,2,1,0,3
3918,0,1210,1837,1499,574,5120
3919,0,2751,4381,3723,2286,13141
3920,0,2385,4184,3385,1939,11893
3921,0,177,370,328,156,1031
3922,0,117,199,167,59,542
3923,0,206,373,285,94,958
3924,0,92,630,186,265,1173
3925,0,332,497,100,272,1201
3926,0,855,1366,1262,539,4022
3927,0,814,1423,1294,556,4087
3928,0,820,1982,1682,686,5170
3929,0,0,0,0,0,0
3930,0,257,473,374,163,1267
3931,0,207,456,383,177,1223
3932,0,4571,7024,5865,2594,20054
3933,0,0,0,0,0,0
3934,0,1170,1911,1422,620,5123
3935,0,6,16,15,7,44
3936,0,11,17,12,5,45
3937,0,889,1910,1777,775,5351
3938,6412,1242,1753,1431,606,5032
3939,4889,1679,3044,2658,1492,8873
3940,0,1791,2940,2436,1239,8406
3941,6450,1999,3756,3358,1449,10562
3942,0,2251,3730,3015,1418,10414
3943,0,712,1184,972,372,3240
3944,2899,413,1106,1034,419,2972
3945,0,941,1506,1224,488,4159
3946,0,2059,7625,3972,3231,16887
3947,0,2689,6569,6154,2608,18020
3948,0,1068,1735,1332,561,4696
3949,0,4974,7708,4206,3650,20538
3950,0,71,260,166,100,597
3951,0,442,800,634,0,1876
3952,0,615,1017,691,455,2778
3953,0,691,1683,1702,429,4505
3954,0,1210,1837,1499,574,5120
3955,0,820,1982,1682,686,5170
3956,0,0,0,0,0,0
3957,0,2751,4381,3723,2286,13141
3958,0,2385,4184,3385,1939,11893
3959,0,2134,3696,3198,1835,10863
3960,0,1730,3123,2732,1895,9480
3961,0,0,0,0,0,0
3962,0,1170,1911,1422,620,5123
3963,0,92,630,186,265,1173
3964,0,332,497,100,272,1201
3965,0,1999,3756,3358,1449,10562
3966,0,2251,3730,3015,1418,10414
3967,6412,889,1910,1777,775,5351
3968,0,596,724,500,203,2023
3969,0,696,1129,1028,438,3291
3970,0,2009,3348,2611,1399,9367
3971,0,0,0,0,0,0
3972,0,691,1683,1702,429,4505
3973,4020,1210,1837,1499,574,5120
3974,0,4571,7024,5865,2594,20054
3975,0,853,6656,1937,2717,12163
3976,0,0,0,0,0,0
3977,0,2059,7625,3972,3231,16887
3978,0,523,1045,1030,428,3026
3979,0,6,16,15,7,44
3980,0,649,1059,923,405,3036
3981,0,0,0,0,0,0
3982,0,1718,3499,3149,1448,9814
3983,0,0,0,0,0,0
3984,0,3614,4937,867,2708,12126
3985,0,62,177,182,61,482
3986,0,13,2,2,23,40
3987,0,85,138,116,46,385
3988,0,1926,3085,2745,1531,9287
3989,0,577,1131,1035,831,3574
3990,0,1953,3115,2478,1243,8789
3991,0,2751,4381,3723,2286,13141
3992,4020,691,1683,1702,429,4505
3993,0,2815,4850,3867,1953,13485
3994,0,301,885,840,368,2394
3995,0,596,724,500,203,2023
3996,0,4453,6426,2943,3148,16970
3997,0,2230,2224,1471,859,6784
3998,0,246,895,974,397,2512
3999,0,421,1559,1947,763,4690
4000,0,2689,6569,6154,2608,18020
4001,0,187,366,318,134,1005
4002,0,206,373,285,94,958
4003,0,0,0,0,0,0
4004,3737,421,1559,1947,763,4690
4005,0,421,1559,1947,763,4690
4007,0,92,630,186,265,1173
4008,0,332,497,100,272,1201
4009,0,301,885,840,368,2394
4010,0,596,724,500,203,2023
4011,0,820,1982,1682,686,5170
4012,0,421,1559,1947,763,4690
4014,0,877,953,617,262,2709
4015,0,246,895,974,397,2512
4016,0,0,0,0,0,0
4017,0,1433,1419,978,644,4474
4018,0,421,1559,1947,763,4690
4020,0,528,1061,1045,435,3069
4021,0,649,1059,923,405,3036
4022,0,421,1559,1947,763,4690
4024,0,4047,6151,5261,2293,17752
4025,0,524,873,604,301,2302
4027,0,1433,1419,978,644,4474
3921,0,79,159,153,66,457
4028,0,257,473,374,163,1267
4029,0,130,298,264,112,804
4030,0,301,885,840,368,2394
4031,0,596,724,500,203,2023
4032,0,1170,1911,1422,620,5123
4033,0,1433,1419,978,644,4474
4034,0,1588,2498,1877,763,6726
4035,0,820,1982,1682,686,5170
4036,0,682,1664,1498,660,4504
4038,0,27,46,38,10,121
4039,0,13,2,2,23,40
4040,0,421,1559,1947,763,4690
4042,0,1433,1419,978,644,4474
4044,0,1433,1419,978,644,4474
4046,0,1433,1419,978,644,4474
4047,0,2662,4893,4408,2156,14119
4048,0,2815,4850,3867,1953,13485
4049,0,543,844,590,241,2218
4050,0,1309,2730,2330,1039,7408
4051,0,1679,3044,2658,1492,8873
4052,0,1791,2940,2436,1239,8406
4053,0,27,46,38,10,121
4054,0,13,2,2,23,40
4055,0,583,2134,2520,1010,6247
4056,3737,1433,1419,978,644,4474
4057,0,0,0,0,0,0
4058,0,2059,7625,3972,3231,16887
4059,0,583,2133,2520,1009,6245
4060,0,0,0,0,0,0
4061,0,877,953,617,262,2709
4062,0,246,895,974,397,2512
4063,0,583,2133,2520,1009,6245
4064,2899,712,1184,972,372,3240
4065,0,413,1106,1034,419,2972
4066,0,162,574,573,247,1556
4067,0,1433,1419,978,644,4474
4230,0,449,555,372,177,1553
4069,0,4453,6426,2943,3148,16970
4070,0,0,0,0,0,0
4071,0,1883,1974,1350,821,6028
4072,0,244,470,367,125,1206
4073,0,27,46,38,10,121
4074,0,179,357,312,147,995
4075,0,109,255,253,70,687
4076,0,2689,6569,6154,2608,18020
4077,0,2059,7625,3972,3231,16887
4078,0,583,2133,2520,1009,6245
4079,0,301,885,840,368,2394
4080,0,596,724,500,203,2023
4081,0,528,1061,1045,435,3069
4082,0,649,1059,923,405,3036
4083,0,2134,3696,3198,1835,10863
4084,0,219,367,306,112,1004
4085,0,244,505,460,222,1431
4086,0,1914,3458,2985,1980,10337
4087,0,855,1366,1262,539,4022
4088,0,814,1423,1294,556,4087
4089,0,2228,4287,3996,1507,12018
4090,0,1819,1865,1265,787,5736
4091,0,301,885,840,368,2394
4092,0,596,724,500,203,2023
4093,0,524,2014,2402,972,5912
4094,0,59,120,118,37,334
4095,0,75,179,183,84,521
4096,0,85,138,116,46,385
4097,0,1569,2770,2235,877,7451
4098,0,440,882,827,346,2495
4099,0,267,481,383,168,1299
4100,0,244,505,460,222,1431
4101,0,1883,1974,1350,821,6028
4102,0,665,1297,1162,493,3617
4103,0,201,439,342,147,1129
4104,0,1345,2693,2294,1050,7382
4105,0,274,518,433,173,1398
4106,0,596,724,500,203,2023
4107,0,301,885,840,368,2394
4108,0,64,109,85,34,292
4109,0,301,885,840,368,2394
4110,5814,596,724,500,203,2023
4111,0,442,800,634,0,1876
4112,0,615,1017,691,455,2778
4113,0,2009,3348,2611,1399,9367
4114,0,0,0,0,0,0
4115,0,524,2014,2402,972,5912
4116,0,187,366,318,134,1005
4117,0,267,481,383,168,1299
4118,0,171,360,331,125,987
4119,0,16,32,15,8,71
4120,0,2228,4287,4008,1507,12030
4121,0,294,523,440,149,1406
4122,0,1779,2871,2593,1856,9099
4123,0,1953,3115,2478,1243,8789
4124,0,1808,3213,2720,1076,8817
4125,0,2166,4556,3752,1636,12110
4126,0,0,0,0,0,0
4127,0,1718,3499,3149,1448,9814
4128,0,528,1061,1045,435,3069
4129,0,649,1059,923,405,3036
4130,0,596,724,500,203,2023
4131,0,301,885,840,368,2394
4132,0,301,885,840,368,2394
4133,0,596,724,500,203,2023
4134,0,64,109,85,34,292
4135,0,235,403,321,112,1071
4136,0,1345,2693,2294,1050,7382
4137,0,294,523,440,149,1406
4138,0,179,335,291,108,913
4139,0,171,360,331,125,987
4140,0,1999,3756,3358,1449,10562
4141,0,2251,3730,3015,1418,10414
4142,0,294,523,440,149,1406
4143,0,263,377,210,159,1009
4144,0,0,0,0,0,0
4145,0,1679,3044,2658,1492,8873
4146,0,1791,2940,2436,1239,8406
4147,0,64,109,85,34,292
4148,0,276,746,615,295,1932
4149,0,43,77,130,29,279
4150,0,2080,7635,3906,3229,16850
4151,0,179,335,291,108,913
4152,0,171,360,331,125,987
4153,0,528,1061,1045,435,3069
4154,0,649,1059,923,405,3036
4155,0,294,523,440,149,1406
4156,0,263,377,210,159,1009
4157,0,0,0,0,0,0
4158,0,4453,6426,2943,3148,16970
4159,0,64,87,63,26,240
4160,0,71,154,206,57,488
4161,0,1999,3756,3358,1449,10562
4162,0,2251,3730,3015,1418,10414
4163,0,712,1184,972,372,3240
4164,0,413,1106,1034,419,2972
4165,0,92,630,186,265,1173
4166,0,332,497,100,272,1201
4167,0,339,855,701,329,2224
4168,0,2662,4893,4408,2156,14119
4169,0,1808,3213,2720,1076,8817
4170,0,131,298,260,113,802
4171,0,179,335,291,108,913
4172,0,154,295,227,101,777
4173,0,1345,2693,2294,1050,7382
4174,0,383,655,369,318,1725
4175,0,853,6656,1937,2717,12163
4176,0,192,272,237,99,800
4177,0,1115,1604,1357,511,4587
4178,0,1700,3246,2510,1442,8898
4179,34221,6149,11218,7959,4937,30263
4180,0,0,0,12,0,12
4181,0,294,523,428,149,1394
4182,0,259,399,53,182,893
4183,0,3548,4809,1051,2625,12033
4184,0,162,575,574,247,1558
4184,0,449,555,372,177,1553
4185,0,2334,4065,3523,1939,11861
4186,7629,1914,3458,2985,1980,10337
4187,0,125,242,211,97,675
4188,0,154,295,227,101,777
4189,0,1345,2693,2294,1050,7382
4190,0,339,855,701,329,2224
4191,0,2166,4556,3752,1636,12110
4192,0,2109,3496,2939,1754,10298
4193,0,1115,1604,1357,511,4587
4194,0,75,179,183,84,521
4195,0,85,138,116,46,385
4196,0,125,242,211,97,675
4197,0,154,295,227,101,777
4198,0,553,1397,1469,402,3821
4199,0,1225,1851,1576,605,5257
4200,0,126,251,166,75,618
4201,0,294,523,428,149,1394
4202,0,679,1648,1635,477,4439
4203,0,1225,1851,1576,605,5257
4204,0,679,1648,1635,477,4439
4205,0,1225,1851,1576,605,5257
4206,0,855,1366,1262,539,4022
4207,0,814,1423,1294,556,4087
4208,0,2228,4287,4008,1507,12030
4209,0,528,1061,1045,435,3069
4210,0,649,1059,923,405,3036
4211,0,11,27,10,11,59
4212,0,16,32,15,8,71
4213,0,125,242,211,97,675
4214,0,154,295,227,101,777
4215,0,818,1395,1032,450,3695
4216,0,339,855,701,329,2224
4217,0,225,647,527,252,1651
4218,0,679,1648,1635,477,4439
4219,0,1225,1851,1576,605,5257
4220,0,442,800,634,0,1876
4221,0,1779,2871,2593,1856,9099
4222,0,2568,4132,3169,1699,11568
4223,0,564,1502,1228,581,3875
4224,0,172,333,282,107,894
4225,0,125,242,211,97,675
4226,0,84,213,196,71,564
4227,0,1679,3044,2658,1492,8873
4038,0,184,280,221,196,881
4228,0,1720,2800,2331,1143,7994
4229,0,692,915,597,259,2463
4230,0,162,575,574,247,1558
4231,0,93,351,327,136,907
4232,0,1999,3756,3358,1449,10562
4233,0,2251,3730,3015,1418,10414
4234,0,855,1366,1262,539,4022
4235,0,814,1423,1294,556,4087
4236,0,712,1184,972,372,3240
4237,0,413,1106,1034,419,2972
4238,0,450,586,505,233,1774
4239,0,638,1125,1035,442,3240
4240,0,430,868,830,334,2462
4241,0,2109,3496,2939,1754,10298
4242,0,110,247,219,94,670
4243,0,1826,3497,2675,1517,9515
4244,0,1819,1865,1265,787,5736
4246,0,564,1502,1228,581,3875
4247,12604,818,1395,1032,450,3695
4248,0,965,6368,2220,2808,12361
4249,0,0,0,0,0,0
6079,0,50,62,21,30,163
4250,0,7,17,18,7,49
4251,0,7,64,18,25,114
4252,0,0,0,0,0,0
4253,0,3548,4809,1051,2625,12033
4254,17002,2452,4933,4535,1758,13678
4255,0,242,359,224,82,907
4256,0,93,351,327,136,907
4257,12604,564,1502,1228,581,3875
4258,0,881,1504,1113,476,3974
4259,5814,301,885,840,368,2394
4260,0,596,724,500,203,2023
4261,7629,2334,4065,3523,1939,11861
4262,0,1914,3458,2985,1980,10337
4263,0,2009,3348,2611,1399,9367
4264,0,0,0,0,0,0
4265,0,75,179,183,84,521
3986,0,196,232,220,145,793
4266,0,155,278,221,142,796
4267,0,0,0,0,0,0
4268,11748,1718,3499,3149,1448,9814
4269,0,855,1366,1262,539,4022
4270,0,814,1423,1294,556,4087
4271,0,679,1648,1635,477,4439
4272,0,1225,1851,1576,605,5257
4273,0,877,953,617,262,2709
4274,0,246,895,974,397,2512
4275,0,855,1366,1262,539,4022
4276,0,814,1423,1294,556,4087
4277,0,242,359,224,82,907
4278,0,54,178,179,75,486
4279,0,39,173,148,62,422
4280,0,528,1061,1045,435,3069
4281,0,649,1059,923,405,3036
4282,0,6149,11218,7959,4937,30263
4283,0,855,1366,1262,539,4022
4284,0,814,1423,1294,556,4087
4285,0,855,1366,1262,539,4022
4286,0,814,1423,1294,556,4087
4287,14908,1225,6268,2644,2690,12827
4288,0,11,27,10,11,59
4289,0,16,32,15,8,71
4290,11748,2009,3348,2611,1399,9367
4291,0,35,59,50,19,163
4292,0,1999,3756,3358,1449,10562
4293,0,2217,3671,2965,1399,10252
4294,0,1718,3499,3149,1448,9814
4295,0,2219,3743,3158,1848,10968
4296,0,1826,3497,2675,1517,9515
4297,0,4427,6428,2939,3155,16949
4298,0,0,0,0,0,0
4299,34052,5762,13506,9533,5993,34794
4300,0,1971,3698,3305,1426,10400
4301,0,63,414,328,47,852
4302,0,2153,3257,2637,1352,9399
4303,0,1598,2953,2555,1448,8554
4304,0,1720,2800,2331,1143,7994
4305,0,52,470,571,58,1151
4306,0,63,414,328,47,852
4307,0,119,170,119,41,449
4308,0,54,178,179,75,486
4309,0,2125,4248,3899,1489,11761
4363,0,344,722,658,283,2007
4311,0,679,1648,1635,477,4439
4312,0,1225,1851,1576,605,5257
4313,0,235,403,321,112,1071
4245,0,1890,3809,3137,1342,10178
4315,0,71,152,131,59,413
4316,0,98,194,197,62,551
4317,0,13,62,65,12,152
4318,0,119,170,119,41,449
4319,0,54,178,179,75,486
4320,0,712,1184,972,372,3240
4321,0,52,470,571,58,1151
4322,0,134,556,459,154,1303
4323,0,301,928,872,257,2358
4324,0,3693,12379,5517,5799,27388
4325,0,301,885,840,368,2394
4326,0,877,953,617,262,2709
4327,0,199,529,591,221,1540
4328,0,1537,2687,2297,924,7445
4329,0,1345,2693,2294,1050,7382
4330,0,87,150,132,62,431
4331,0,216,635,485,144,1480
4332,0,47,406,328,92,873
4333,0,965,6368,2220,2808,12361
4334,0,3548,4809,1051,2625,12033
4335,0,138,485,351,77,1051
4336,0,47,406,328,92,873
4337,0,528,1061,1045,435,3069
4338,0,649,1059,923,405,3036
4339,0,2219,3743,3158,1848,10968
4340,11528,1826,3497,2675,1517,9515
4341,0,2125,4212,3458,1453,11248
4342,0,124,189,106,41,460
4343,0,39,173,148,62,422
4344,0,2334,4065,3523,1939,11861
4345,0,1914,3458,2985,1980,10337
4346,0,452,814,676,344,2286
4347,0,156,270,287,129,842
4348,0,302,670,540,202,1714
4349,0,119,170,119,41,449
4350,0,54,178,179,75,486
4351,0,528,1061,1045,435,3069
4352,0,649,1059,923,405,3036
4353,0,1537,2687,2297,924,7445
4354,0,1345,2693,2294,1050,7382
4355,0,124,189,106,41,460
4356,0,39,173,148,62,422
4357,0,11,27,10,11,59
4358,0,16,32,15,8,71
4359,0,2009,3348,2611,1399,9367
4360,0,528,1061,1045,435,3069
4361,0,218,299,226,107,850
4362,0,119,170,119,41,449
4363,0,54,178,179,75,486
4364,0,679,1648,1635,477,4439
4365,0,1225,1851,1576,605,5257
4366,0,161,183,124,69,537
4367,0,468,928,918,416,2730
4368,0,1381,2890,2516,1146,7933
4369,0,1919,3228,2735,1368,9250
4370,0,2153,3257,2637,1352,9399
4371,0,564,1502,1228,581,3875
4372,7063,881,1504,1113,476,3974
4373,0,1598,2953,2555,1448,8554
4374,0,1720,2800,2331,1143,7994
4375,0,138,485,351,77,1051
4376,0,47,406,328,92,873
4377,0,679,1648,1635,477,4439
4378,0,1225,1851,1576,605,5257
4379,0,2221,3670,3227,1856,10974
4380,0,2568,4132,3169,1699,11568
4381,0,205,384,325,146,1060
4382,0,508,982,1026,231,2747
4383,0,408,1152,1051,333,2944
4384,0,965,6368,2220,2808,12361
4385,0,0,0,0,0,0
4386,0,92,630,186,265,1173
4387,0,332,497,100,272,1201
4388,0,0,0,0,0,0
4389,0,3548,4809,1051,2625,12033
4390,0,11,27,10,11,59
4391,0,16,32,15,8,71
4392,0,2125,4248,3899,1489,11761
4393,0,0,0,0,0,0
4394,0,1225,6268,2644,2690,12827
4395,14908,3613,5005,1645,2599,12862
4396,0,0,0,0,0,0
4397,21917,3939,10313,7074,4281,25607
4398,0,182,311,257,119,869
4399,0,138,485,351,77,1051
4400,0,197,730,609,210,1746
4401,0,92,630,186,265,1173
4402,0,332,497,100,272,1201
4403,0,1638,2721,2041,1120,7520
4404,0,5884,9625,6135,4249,25893
4405,0,337,656,576,228,1797
4406,0,302,670,540,202,1714
4407,0,1381,2890,2516,1146,7933
4408,0,2334,4065,3523,1939,11861
4409,0,1914,3458,2985,1980,10337
4410,0,19,41,77,13,150
4411,0,13,62,65,12,152
4412,0,1537,2687,2297,924,7445
4413,0,1345,2693,2294,1050,7382
4414,0,124,189,106,41,460
4415,0,39,173,148,62,422
4416,0,2125,4212,3458,1453,11248
4417,0,119,170,119,41,449
4418,0,54,178,179,75,486
4419,0,628,983,716,354,2681
4420,0,415,1078,877,424,2794
4422,0,17,37,22,14,90
4423,0,2162,4390,4057,1550,12159
4424,28896,5111,10940,4713,5482,26246
4425,0,415,1078,877,424,2794
4426,0,628,983,716,354,2681
4470,0,1510,2487,1829,831,6657
4427,7063,564,1502,1228,581,3875
4428,0,415,1078,877,424,2794
4429,0,118,161,144,48,471
4430,0,71,154,206,57,488
4431,0,2221,3670,3227,1856,10974
4432,11050,2568,4132,3169,1699,11568
4433,0,11,27,10,11,59
4434,0,16,32,15,8,71
4435,0,882,1088,889,529,3388
4436,0,2812,11291,4628,5270,24001
4437,0,19,41,77,13,150
4438,0,13,62,65,12,152
4439,0,1919,3228,2735,1368,9250
4440,0,2153,3257,2637,1352,9399
4441,0,124,189,106,41,460
4442,0,39,173,148,62,422
4443,0,679,1648,1635,477,4439
4444,0,1225,1851,1576,605,5257
4445,0,626,1194,1205,307,3332
4446,0,408,1152,1051,333,2944
4447,0,4784,9825,3414,5103,23126
4448,0,1638,2721,2041,1120,7520
4449,0,1381,2890,2516,1146,7933
4450,0,11,27,10,11,59
4451,0,16,32,15,8,71
4452,0,321,796,607,196,1920
4453,0,197,730,609,210,1746
4454,0,634,1426,1362,570,3992
4455,0,679,1648,1635,477,4439
4456,4668,1578,2233,1735,680,6226
4457,0,518,843,720,332,2413
4458,0,430,868,830,334,2462
4459,0,2334,4065,3523,1939,11861
4460,0,1914,3458,2985,1980,10337
4461,11528,2219,3743,3158,1848,10968
4462,0,1826,3497,2675,1517,9515
4463,11050,2221,3670,3227,1856,10974
4464,0,92,263,133,91,579
4465,0,2476,3869,3036,1608,10989
4466,0,6,59,17,23,105
4467,0,34,42,6,23,105
4468,0,2226,4345,3555,1481,11607
4469,0,2162,4390,4057,1550,12159
4471,0,628,983,716,354,2681
4472,0,415,1078,877,424,2794
4473,0,518,843,720,332,2413
4474,0,430,868,830,334,2462
4475,0,601,1490,823,660,3574
4476,0,535,748,573,251,2107
4477,0,124,189,106,41,460
4478,0,172,512,589,224,1497
4479,0,1598,2953,2555,1448,8554
4480,0,1720,2800,2331,1143,7994
4481,0,2221,3670,3227,1856,10974
4482,0,509,1227,690,570,2996
4483,0,2476,3869,3036,1608,10989
4484,0,157,335,297,147,936
4485,0,11,27,10,11,59
4486,0,218,373,261,128,980
4487,0,1425,2245,1750,1335,6755
4488,0,1045,1927,1371,1015,5358
4489,0,0,0,0,0,0
4490,0,19,41,77,13,150
4491,0,13,62,65,12,152
4492,0,92,630,186,265,1173
4493,0,332,497,100,272,1201
4494,0,2334,4065,3523,1939,11861
4495,0,2099,3845,3292,2171,11407
4084,0,330,561,476,246,1613
4496,0,415,1078,877,424,2794
4497,0,263,377,210,159,1009
4498,0,0,0,0,0,0
4499,0,1919,3228,2735,1368,9250
4500,0,697,1678,1663,554,4592
4501,0,1515,2246,1847,894,6502
4502,0,1313,2166,1643,647,5769
4503,0,1156,1912,1594,491,5153
4504,0,697,1678,1663,554,4592
4505,0,1156,1912,1594,491,5153
4506,0,697,1678,1663,554,4592
4507,0,594,747,529,234,2104
4508,0,172,512,589,224,1497
4509,4668,736,1976,2075,619,5406
4510,0,1578,2233,1735,680,6226
4511,0,628,983,716,354,2681
4512,0,415,1078,877,424,2794
4513,0,626,1194,1205,307,3332
4514,0,1172,2038,1723,923,5856
4515,3186,1158,1641,1377,764,4940
4516,0,126,324,296,75,821
4517,0,736,1976,2075,619,5406
4518,0,1578,2233,1735,680,6226
4519,0,415,1078,877,424,2794
4520,3186,1008,1480,1392,771,4651
4521,0,1158,1641,1377,764,4940
4522,0,2219,3743,3158,1848,10968
4523,0,1045,1927,1371,1015,5358
4524,0,781,1570,1304,502,4157
4525,0,0,0,0,0,0
4526,0,1225,6268,2644,2690,12827
4527,0,337,656,576,228,1797
4528,0,302,670,540,202,1714
4529,0,168,362,307,157,994
4530,0,218,373,261,128,980
4531,0,1638,2721,2041,1120,7520
4532,0,0,0,0,0,0
4533,0,2730,4897,3917,2426,13970
4534,0,185,313,237,122,857
4535,9747,2974,4682,3847,2092,13595
4536,0,3613,5005,1645,2599,12862
4537,0,0,0,0,0,0
4538,0,321,796,607,196,1920
4539,0,1008,1480,1392,771,4651
4540,0,1130,2014,1699,866,5709
4541,0,123,182,140,37,482
4542,0,5762,13506,9533,5993,34794
4543,0,0,0,0,0,0
4544,0,1381,2890,2516,1146,7933
4545,0,736,1976,2075,619,5406
4546,0,1578,2233,1735,680,6226
4547,0,1425,2245,1750,1335,6755
4548,0,1045,1927,1371,1015,5358
4549,0,3414,6022,4965,3032,17433
4550,0,1239,1953,1321,908,5421
4551,0,2512,4265,3611,2097,12485
4552,0,2099,3845,3292,2171,11407
4553,0,1176,1940,1679,851,5646
4554,0,1130,2014,1699,866,5709
4555,0,82,224,117,98,521
4556,0,57,219,92,77,445
4557,0,189,495,388,312,1384
4558,0,2226,4345,3555,1481,11607
4559,0,0,0,0,0,0
4560,0,736,1976,2075,619,5406
4561,0,1578,2233,1735,680,6226
4562,0,0,0,0,0,0
4563,0,882,1088,889,529,3388
4564,0,0,0,0,0,0
4565,0,2162,4390,4057,1550,12159
4566,0,8320,13482,9300,6023,37125
4567,0,3338,8823,6251,3620,22032
4568,0,753,1237,992,442,3424
4569,0,0,0,0,0,0
4570,0,1225,6268,2644,2690,12827
4571,0,736,1976,2075,619,5406
4572,0,1578,2233,1735,680,6226
4573,0,1598,2953,2555,1448,8554
4574,0,1720,2800,2331,1143,7994
4575,0,92,630,186,265,1173
4576,0,332,497,100,272,1201
4577,0,82,224,117,98,521
4578,0,70,238,82,122,512
4579,0,57,219,92,77,445
4580,0,168,362,307,157,994
4581,0,218,373,261,128,980
4582,0,628,983,716,354,2681
4583,0,415,1078,877,424,2794
4584,0,3613,5005,1645,2599,12862
4585,0,0,0,0,0,0
4586,0,3727,5919,4839,2534,17019
4587,0,1425,2245,1750,1335,6755
4588,0,3129,5590,4628,2785,16132
4589,0,249,412,303,153,1117
4590,9747,1338,2073,1421,1033,5865
4591,0,327,1116,1300,379,3122
4592,0,979,1110,420,441,2950
4593,0,1156,1912,1594,491,5153
4594,0,697,1678,1663,554,4592
4595,0,327,1116,1300,379,3122
4596,0,979,1110,420,441,2950
4597,0,0,0,0,0,0
4598,0,2436,3857,3164,1774,11231
4599,0,1291,2062,1675,760,5788
4600,0,963,2112,1935,697,5707
4601,0,1313,2166,1643,647,5769
4602,0,327,1116,1300,379,3122
4603,0,149,1001,530,340,2020
4604,0,1861,2198,1309,970,6338
4605,0,55,173,88,80,396
4606,0,259,732,470,434,1895
4607,0,19,40,77,13,149
4608,0,13,62,65,12,152
4609,0,1338,2073,1421,1033,5865
4610,0,150,319,311,70,850
4611,0,126,324,296,75,821
4612,0,1225,6268,2644,2690,12827
4613,0,4091,10061,7243,4063,25458
4614,0,3613,5005,1645,2599,12862
4615,0,1638,2721,2041,1120,7520
4616,0,0,0,0,0,0
4617,0,931,1291,721,685,3628
4618,0,7389,12191,8579,5338,33497
4619,7427,1291,2062,1675,760,5788
4620,0,0,0,0,0,0
4621,0,1381,2890,2516,1146,7933
4622,0,149,1001,530,340,2020
4623,0,415,1078,877,424,2794
4624,0,628,983,716,354,2681
4625,0,1537,2687,2297,924,7445
4626,0,1345,2693,2294,1050,7382
4627,0,407,782,701,349,2239
4628,0,881,2043,1769,761,5454
4629,0,337,656,576,228,1797
4630,0,302,670,540,202,1714
4631,0,736,1976,2075,619,5406
4632,0,1578,2233,1735,680,6226
4633,0,594,747,529,234,2104
4634,0,172,512,589,224,1497
4635,0,52,161,174,46,433
4636,0,123,182,140,37,482
4637,0,1176,1940,1679,851,5646
4638,3808,1130,2014,1699,866,5709
4639,0,2512,4265,3611,2097,12485
4640,0,2099,3845,3292,2171,11407
4641,0,2519,4367,3989,2350,13225
4642,0,249,412,303,153,1117
4643,0,965,6368,2220,2808,12361
4644,0,0,0,0,0,0
4645,0,1225,6268,2644,2690,12827
4646,0,118,161,144,48,471
4647,0,71,154,206,57,488
4648,0,3565,4836,1587,2536,12524
4649,0,68,200,70,107,445
4650,0,0,0,0,0,0
4651,0,3548,4809,1051,2625,12033
4652,0,47,169,60,64,340
4653,0,68,200,70,107,445
4654,0,594,747,529,234,2104
4655,0,172,512,589,224,1497
4656,0,1156,1912,1594,491,5153
4657,0,697,1678,1663,554,4592
4658,0,2233,3710,3454,2045,11442
4659,0,264,409,301,123,1097
4660,0,2226,4345,3555,1481,11607
4661,0,736,1976,2075,619,5406
4662,0,1578,2233,1735,680,6226
4663,0,400,727,518,271,1916
4664,6274,325,886,578,275,2064
4665,0,1537,2687,2297,924,7445
4666,7427,1288,2824,2469,1109,7690
4667,0,309,527,409,210,1455
4668,5386,334,474,367,209,1384
4669,0,2162,4390,4057,1550,12159
4670,0,285,657,534,305,1781
4671,0,513,821,605,276,2215
4672,0,168,362,307,157,994
4673,0,218,373,261,128,980
4674,0,599,923,737,373,2632
4675,0,476,2117,1830,719,5142
4676,7329,1854,2312,1480,1012,6658
4677,0,600,1033,899,211,2743
4678,0,736,1976,2075,619,5406
4679,0,1322,1945,1589,780,5636
4680,0,325,886,578,275,2064
4681,0,400,727,518,271,1916
4682,0,1225,6268,2644,2690,12827
4683,0,1638,2721,2041,1120,7520
4684,6274,400,727,518,271,1916
4685,0,325,886,578,275,2064
4686,0,150,319,311,70,850
4687,0,126,324,296,75,821
4688,0,3633,5035,1657,2643,12968
4689,0,55,173,88,80,396
4690,0,259,732,470,434,1895
4691,0,325,886,578,275,2064
4692,0,400,727,518,271,1916
4693,0,594,747,529,234,2104
4694,0,172,512,589,224,1497
4695,0,337,796,790,270,2193
4696,0,325,886,578,275,2064
4697,0,883,1557,1204,496,4140
4906,0,47,113,105,43,308
4698,0,19,40,77,13,149
4699,0,82,175,157,48,462
4700,0,400,727,518,271,1916
4701,0,325,886,578,275,2064
4702,0,555,879,695,280,2409
4703,0,384,1042,1164,376,2966
4704,0,1322,1945,1589,780,5636
4705,0,337,656,576,228,1797
4706,3808,1176,1940,1679,851,5646
4707,0,958,1700,1399,761,4818
4708,0,219,483,410,147,1259
4709,0,13,62,65,12,152
4710,0,19,40,77,13,149
4711,0,52,161,174,46,433
4712,0,123,182,140,37,482
4713,0,1368,2604,2140,878,6990
4714,0,1088,2216,1988,789,6081
4715,0,1088,2216,1988,789,6081
4716,8709,1368,2604,2140,878,6990
4717,0,2512,4265,3611,2097,12485
4718,0,2099,3845,3292,2171,11407
4719,0,1368,2604,2140,878,6990
4720,0,1088,2216,1988,789,6081
4721,0,55,173,88,80,396
4722,0,1170,6096,2557,2610,12433
4723,0,939,1921,1860,656,5376
4724,0,1322,1945,1589,780,5636
4725,0,58,129,123,17,327
4726,0,400,727,518,271,1916
4727,0,1327,2779,2418,1109,7633
4728,0,93,192,149,32,466
4729,0,963,2112,1935,697,5707
4730,0,1219,1974,1494,615,5302
4731,0,19,40,77,13,149
4732,0,13,62,65,12,152
4733,0,594,747,529,234,2104
4734,8709,1088,2216,1988,789,6081
4735,0,937,2115,1786,715,5553
4736,0,58,129,123,17,327
4737,0,1594,3536,2872,1367,9369
4738,0,118,161,144,48,471
4739,0,71,154,206,57,488
4740,0,1029,1619,1406,748,4802
4741,0,958,1700,1399,761,4818
4742,0,3633,5035,1657,2643,12968
4743,0,2226,4345,3555,1481,11607
4744,0,1368,2604,2140,878,6990
4745,0,2015,3879,3448,1421,10763
4746,0,527,1280,1287,419,3513
4747,0,263,377,210,159,1009
4748,0,0,0,0,0,0
4749,7329,592,2158,1927,757,5434
4750,0,1854,2312,1480,1012,6658
4751,0,1078,1962,1573,634,5247
4752,0,937,2115,1786,715,5553
4753,0,1429,6828,3027,3044,14328
4754,0,965,6368,2220,2808,12361
4755,0,3633,5035,1657,2643,12968
4756,0,36,46,7,25,114
4757,0,7,64,18,25,114
4758,0,447,919,812,368,2546
4759,0,309,527,409,210,1455
4760,0,1598,2953,2555,1448,8554
4761,0,1720,2800,2331,1143,7994
4762,0,1078,1962,1573,634,5247
4763,0,937,2115,1786,715,5553
4764,0,3633,5035,1657,2643,12968
4765,0,563,882,648,248,2341
4766,0,285,657,534,305,1781
4767,0,235,536,484,235,1490
4768,0,168,362,307,157,994
4769,0,218,373,261,128,980
4770,0,1580,2592,1918,1103,7193
4771,0,346,617,420,235,1618
4772,0,1029,1619,1406,748,4802
4773,0,958,1700,1399,761,4818
4774,41936,6564,12296,8836,5360,33056
4775,0,4091,10061,7243,4063,25458
4776,0,1429,6828,3027,3044,14328
4777,0,8271,14234,10348,6099,38952
4778,0,518,843,720,332,2413
4779,0,661,1680,1367,545,4253
4780,0,953,1740,1429,580,4702
4781,0,1969,2055,1491,1001,6516
4782,0,592,2158,1927,757,5434
4783,0,1811,3304,2723,1725,9563
4785,0,1029,1619,1406,748,4802
4786,0,1056,1989,1730,860,5635
4787,0,157,198,158,65,578
4788,0,36,46,7,25,114
4789,0,7,64,18,25,114
4790,0,1187,1816,1564,813,5380
4791,0,1040,1877,1565,845,5327
4792,0,58,129,117,39,343
4793,0,86,249,290,56,681
4795,0,1429,6828,3027,3044,14328
4796,0,3633,5035,1657,2643,12968
4797,0,5762,13506,9533,5993,34794
4798,0,628,983,716,354,2681
4799,0,1078,1962,1573,634,5247
4800,0,937,2115,1786,715,5553
4801,0,97,289,112,140,638
4802,0,123,419,162,185,889
4804,0,3633,5035,1657,2643,12968
4805,0,47,169,60,64,340
4806,0,68,200,70,107,445
4807,0,0,0,0,0,0
4808,0,92,630,186,265,1173
4809,0,332,497,100,272,1201
4810,0,1179,1834,1583,820,5416
4811,0,1040,1877,1565,845,5327
4812,0,1429,6828,3027,3044,14328
4813,0,819,1839,1482,627,4767
4814,0,887,1563,1201,492,4143
4815,0,181,380,399,154,1114
4816,0,47,169,60,64,340
4817,0,66,154,182,56,458
4818,0,82,175,157,48,462
4819,0,150,319,311,70,850
4820,0,126,324,296,75,821
4821,0,97,289,112,140,638
4822,0,123,419,162,185,889
4823,0,1429,6828,3027,3044,14328
4824,0,3633,5035,1657,2643,12968
4825,0,227,477,419,171,1294
4826,0,219,483,410,147,1259
4827,0,2512,4265,3611,2097,12485
4828,0,1179,1834,1583,820,5416
4829,0,1937,3443,2777,1976,10133
4830,0,1373,2548,2262,1135,7318
4831,0,1962,3077,2012,1312,8363
4832,0,1811,3304,2723,1725,9563
4833,0,1078,1962,1573,634,5247
4834,0,937,2115,1786,715,5553
4835,0,965,6368,2220,2808,12361
4836,0,2497,4119,3756,2169,12541
4837,0,4091,10061,7243,4063,25458
4838,0,925,1933,1747,660,5265
4839,0,150,319,311,70,850
4840,0,1345,2298,1790,691,6124
4841,0,47,169,60,64,340
4842,0,97,289,112,140,638
4843,0,76,250,102,120,548
4844,0,8271,14234,10348,6099,38952
4845,0,87,91,66,16,260
4846,0,52,161,174,46,433
4847,1529,36,91,74,20,221
4848,0,2233,4385,3462,1503,11583
4849,0,2015,3879,3448,1421,10763
4850,0,1962,3077,2012,1312,8363
4851,0,1811,3304,2723,1725,9563
4852,0,3548,4809,1051,2625,12033
4853,0,717,1770,1389,575,4451
4854,0,887,1563,1201,492,4143
4855,5386,385,838,761,275,2259
4856,0,334,474,367,209,1384
4857,0,1076,2252,2058,730,6116
4858,0,1345,2298,1790,691,6124
4859,0,2126,3461,2978,1812,10377
4860,0,115,237,198,96,646
4861,0,1937,3443,2774,1976,10130
4862,0,1078,1962,1573,634,5247
4863,0,937,2115,1786,715,5553
4865,0,1429,6828,3027,3044,14328
4866,0,1735,2907,2398,1200,8240
4867,0,1488,2785,2460,1232,7965
4868,0,1078,1962,1573,634,5247
4869,0,937,2115,1786,715,5553
4870,0,66,154,182,56,458
4871,0,82,175,157,48,462
4872,0,1598,2953,2555,1448,8554
4981,0,151,199,169,111,630
4873,5061,1571,2606,2165,1148,7490
4874,0,1735,2907,2398,1200,8240
4875,0,1488,2785,2460,1232,7965
4876,0,3633,5035,1657,2643,12968
4878,0,447,919,812,368,2546
4879,0,309,527,409,210,1455
4880,0,794,1498,1408,513,4213
4881,0,249,373,268,167,1057
4882,0,849,1753,1450,617,4669
4883,0,2233,4385,3462,1503,11583
4884,0,2015,3879,3448,1421,10763
4885,0,168,362,307,157,994
4886,0,1735,2907,2398,1200,8240
4887,0,1347,2482,2177,1093,7099
4888,0,1962,3077,2012,1312,8363
4889,0,1811,3304,2723,1725,9563
4890,0,654,1118,924,357,3053
4891,0,527,1280,1287,419,3513
4892,0,1076,2252,2058,730,6116
4893,0,1345,2298,1790,691,6124
4894,0,98,289,332,99,818
4895,0,157,198,158,65,578
4896,0,1544,2594,2161,1091,7390
4897,0,1347,2482,2177,1093,7099
4898,0,939,1921,1860,656,5376
4899,0,1322,1945,1589,780,5636
4900,0,810,1484,1261,551,4106
4901,0,717,1770,1389,575,4451
4902,0,1078,1962,1573,634,5247
4903,0,227,477,419,171,1294
4904,0,97,138,131,215,581
4981,0,72,145,154,63,434
4904,0,296,532,422,78,1328
4905,0,6588,14179,10999,6231,37997
4907,0,1544,2594,2161,1091,7390
4908,0,1347,2482,2177,1093,7099
4909,0,263,377,210,159,1009
4910,0,234,439,435,192,1300
4911,0,1210,6456,2626,2878,13170
4912,0,1926,3209,2338,1337,8810
4913,0,8271,14234,10348,6099,38952
4914,0,1594,3536,2872,1367,9369
5358,0,277,494,457,218,1446
4915,0,3633,5035,1657,2643,12968
4916,0,278,444,244,185,1151
4917,0,4784,9825,3414,5103,23126
4918,0,1320,2332,2070,805,6527
4919,0,2233,4385,3462,1503,11583
4920,0,1623,3308,2934,1219,9084
4921,0,1076,2252,2058,730,6116
4922,0,1345,2298,1790,691,6124
4923,0,118,161,144,48,471
4924,0,71,154,206,57,488
4925,0,877,1517,1339,559,4292
4926,0,849,1753,1450,617,4669
4927,0,33,68,62,24,187
4928,0,66,154,182,56,458
4929,0,1544,2594,2161,1091,7390
4930,0,1451,2698,2366,1151,7666
4931,0,6588,14179,10999,6231,37997
4932,0,36,46,7,25,114
4933,0,965,6368,2220,2808,12361
4934,0,0,0,0,0,0
4935,0,2960,12292,5158,5609,26019
4936,5061,1502,2820,2427,1349,8098
4937,0,1571,2606,2165,1148,7490
4938,1529,36,73,62,24,195
4939,0,36,91,74,20,221
4940,0,8271,14234,10348,6099,38952
4941,0,1623,2778,2372,1160,7933
4942,0,1451,2698,2366,1151,7666
4943,0,216,272,264,117,869
4944,0,163,344,368,142,1017
4945,0,18,35,31,12,96
4946,0,468,641,438,171,1718
4947,0,877,1517,1339,559,4292
4948,0,831,1999,1747,741,5318
4949,0,98,289,332,99,818
4904,0,83,135,113,60,391
4950,0,229,342,312,128,1011
4951,0,36,46,7,25,114
4952,0,3512,4764,1044,2600,11920
4953,0,385,838,761,275,2259
4954,0,334,474,367,209,1384
4955,0,0,0,0,0,0
4956,0,1623,2778,2372,1160,7933
4957,0,1451,2698,2366,1151,7666
4958,0,1945,3778,2976,1226,9925
4959,0,1623,3308,2934,1219,9084
4960,0,6588,14179,10999,6231,37997
4961,0,1962,3077,2012,1312,8363
4962,8827,1811,3304,2723,1725,9563
4963,0,447,919,812,368,2546
4964,4339,309,527,409,210,1455
4965,0,8271,14234,10348,6099,38952
4966,0,1623,2778,2372,1160,7933
4967,0,1451,2698,2366,1151,7666
4969,14411,1210,6456,2626,2878,13170
4970,0,979,1110,420,441,2950
4971,0,4784,9825,3414,5103,23126
4972,0,760,1583,1446,611,4400
4973,0,1945,3778,2976,1226,9925
4974,0,1716,3486,2986,1183,9371
4975,0,3652,5016,1483,2667,12818
4977,0,1134,1765,1447,593,4939
4978,0,385,838,761,275,2259
4979,0,922,1675,1526,690,4813
4980,0,849,1654,1273,624,4400
4981,0,240,475,435,210,1360
4982,0,296,532,422,78,1328
4983,8827,1962,3077,2012,1312,8363
4984,0,1811,3304,2723,1725,9563
4985,0,181,424,444,159,1208
4986,0,229,342,312,128,1011
4987,0,1623,2778,2372,1160,7933
4988,0,1451,2698,2366,1151,7666
4989,0,1623,2778,2372,1160,7933
4990,5650,1451,2698,2366,1151,7666
4992,0,1210,6456,2626,2878,13170
4993,0,838,1327,1151,442,3758
4994,0,922,1675,1526,690,4813
4995,0,90,138,97,34,359
4996,0,118,161,144,48,471
4997,0,114,287,331,113,845
4998,0,181,424,444,159,1208
4999,0,229,342,312,128,1011
5000,14411,3652,5016,1483,2667,12818
5002,0,2960,12292,5158,5609,26019
5003,5650,1623,2778,2372,1160,7933
5004,0,1451,2698,2366,1151,7666
5005,0,654,1118,924,357,3053
5006,5242,527,1280,1287,419,3513
5007,0,6588,14179,10999,6231,37997
5008,0,157,325,269,147,898
5009,0,181,424,444,159,1208
5010,0,213,301,219,91,824
5011,0,96,207,193,80,576
5012,0,2242,3698,3172,1909,11021
5013,0,1991,3613,2845,1912,10361
5014,0,1671,3404,2878,1136,9089
5015,0,1716,3486,2986,1183,9371
5016,0,1502,2820,2427,1349,8098
5017,0,1571,2606,2165,1148,7490
5018,0,6744,12513,9266,5371,33894
5019,0,1527,1721,1081,728,5057
5020,0,1926,3209,2338,1337,8810
5021,0,1962,3077,2012,1312,8363
5022,0,1280,2221,1981,1031,6513
5023,0,958,6304,2202,2783,12247
5024,0,1671,3404,2878,1136,9089
5025,0,1716,3486,2986,1183,9371
5026,0,1623,2778,2372,1160,7933
5027,0,1451,2698,2366,1151,7666
5028,0,1770,2867,1944,1231,7812
5029,0,1217,2129,1868,944,6158
5030,0,1023,2746,2442,1005,7216
5031,0,577,1215,1070,324,3186
5032,0,939,1921,1860,656,5376
5033,0,1059,1750,1370,653,4832
5034,0,1755,2854,2218,1266,8093
5035,0,3512,4764,1044,2600,11920
5036,0,133,290,263,112,798
5037,0,1623,2778,2372,1160,7933
5038,0,1530,2850,2470,1206,8056
5039,0,752,1627,1422,633,4434
5040,0,1059,1750,1370,653,4832
5041,0,752,1627,1422,633,4434
5042,0,1059,1750,1370,653,4832
5043,4339,447,919,812,368,2546
5044,0,309,527,409,210,1455
5045,0,752,1627,1422,633,4434
5046,0,1059,1750,1370,653,4832
5047,0,838,1327,1151,442,3758
5048,4246,922,1675,1526,690,4813
5049,0,230,293,215,132,870
5050,0,418,358,245,114,1135
5051,0,752,1627,1422,633,4434
5052,0,1082,2018,1759,847,5706
5053,0,1671,3404,2878,1136,9089
5054,0,1635,3187,2690,1095,8607
5055,0,82,299,296,88,765
5056,0,1168,1884,1513,730,5295
5057,0,1082,2018,1759,847,5706
5058,0,1287,2132,1741,791,5951
5059,8828,849,1654,1273,624,4400
5060,0,208,300,241,83,832
5061,0,114,287,331,113,845
5062,0,1076,2252,2058,730,6116
5063,0,1168,1884,1513,730,5295
5064,0,1003,1586,1338,746,4673
5065,0,1284,2504,2005,715,6508
5066,0,902,1472,1256,652,4282
5067,0,1003,1586,1338,746,4673
5068,0,958,6304,2202,2783,12247
5069,0,240,475,435,210,1360
5070,0,296,532,422,78,1328
5071,0,1493,3074,2638,1031,8236
5072,0,1635,3187,2690,1095,8607
5073,0,36,73,62,24,195
5074,0,902,1472,1256,652,4282
5075,0,1910,3434,2906,1581,9831
5076,0,1025,1473,1201,559,4258
5077,0,185,219,222,106,732
5078,0,163,344,368,142,1017
5079,0,3512,4764,1044,2600,11920
5080,0,374,395,270,163,1202
5081,0,1713,2585,2114,1095,7507
5082,0,1826,3487,3041,1620,9974
5083,0,1136,1984,1401,783,5304
5084,0,1217,2129,1868,944,6158
5086,0,1210,6456,2626,2878,13170
5087,0,658,1142,989,438,3227
5088,0,447,919,812,368,2546
5089,0,582,993,798,381,2754
5090,0,6588,14179,10999,6231,37997
5091,0,3652,5016,1483,2667,12818
5093,5242,654,1118,924,357,3053
5094,0,527,1280,1287,419,3513
5095,0,1658,2917,2518,1219,8312
5096,0,1402,2645,2367,1153,7567
5097,0,483,720,497,333,2033
5098,0,1870,2619,2046,1089,7624
5099,0,1826,3487,3041,1620,9974
5100,0,32,53,43,11,139
5101,0,18,35,31,12,96
5102,0,183,469,447,183,1282
5103,0,213,301,219,91,824
5104,0,6744,12513,9266,5371,33894
5105,0,1493,3074,2638,1031,8236
5106,0,1635,3187,2690,1095,8607
5107,8828,1287,2132,1741,791,5951
5108,0,849,1654,1273,624,4400
5109,0,1502,2820,2427,1349,8098
5110,0,1870,2619,2046,1089,7624
5111,0,345,740,646,340,2071
5112,2705,234,850,802,245,2131
5113,0,92,630,186,265,1173
5114,0,332,497,100,272,1201
5115,0,1770,2894,2422,1252,8338
5116,0,1402,2645,2367,1153,7567
5117,0,183,469,447,183,1282
5118,0,213,301,219,91,824
5119,0,6,59,17,23,105
5120,0,10,20,13,7,50
5121,0,44,59,20,31,154
5122,0,1287,2132,1741,791,5951
5123,0,552,1001,808,353,2714
5124,0,321,701,509,289,1820
5125,4246,838,1327,1151,442,3758
5126,0,922,1675,1526,690,4813
5127,0,1770,2894,2422,1252,8338
5128,0,1402,2645,2367,1153,7567
5129,0,185,219,222,106,732
5130,0,163,344,368,142,1017
5131,0,486,802,639,186,2113
5132,0,345,740,646,340,2071
5133,0,1588,2336,1663,724,6311
5134,0,0,0,0,0,0
5135,0,1493,3074,2638,1031,8236
5136,0,1635,3187,2690,1095,8607
5137,0,0,0,0,0,0
5138,0,1023,2746,2442,1005,7216
5139,0,1770,2894,2422,1252,8338
5140,0,1402,2645,2367,1153,7567
5141,0,1201,2438,2109,731,6479
5142,0,1284,2504,2005,715,6508
5143,0,11,18,14,8,51
5144,0,10,20,13,7,50
5145,0,1201,2438,2109,731,6479
5146,0,1284,2504,2005,715,6508
5147,0,240,475,435,210,1360
5148,0,486,802,639,186,2113
5149,0,325,611,526,279,1741
5150,0,1380,2550,2212,909,7051
5151,5732,1755,2854,2218,1266,8093
5152,0,1122,2190,1899,954,6165
5153,0,1025,1473,1201,559,4258
5154,0,654,1118,924,357,3053
5155,0,527,1280,1287,419,3513
5156,0,864,1453,1219,552,4088
5157,0,552,1001,808,353,2714
5158,0,1770,2894,2422,1252,8338
5159,0,1402,2645,2367,1153,7567
5160,0,409,616,531,256,1812
5161,0,325,611,526,279,1741
5162,0,1493,3074,2638,1031,8236
5163,0,1635,3187,2690,1095,8607
5164,0,16,78,29,30,153
5165,0,44,59,20,31,154
5166,0,764,1337,1181,529,3811
5167,0,838,1327,1151,442,3758
5168,0,701,1309,1150,547,3707
5169,0,301,736,736,211,1984
5170,0,185,219,222,106,732
5171,0,380,706,647,221,1954
5172,0,183,469,447,183,1282
5173,0,409,616,531,256,1812
5174,0,125,274,236,103,738
5175,0,157,231,160,80,628
5176,0,32,53,43,11,139
5177,0,18,35,31,12,96
5178,0,799,1305,1159,447,3710
5179,0,701,1309,1150,547,3707
5180,0,189,255,203,139,786
5181,0,125,274,236,103,738
5182,0,5763,10935,3833,5544,26075
5183,0,1770,2894,2422,1252,8338
5184,0,1402,2645,2367,1153,7567
5185,0,1210,6456,2626,2878,13170
5186,0,318,697,684,204,1903
5187,0,380,706,647,221,1954
5188,0,189,255,203,139,786
5189,0,125,274,236,103,738
5190,0,3652,5016,1483,2667,12818
5191,0,2960,12292,5158,5609,26019
5192,0,1136,1984,1401,783,5304
5193,0,1217,2129,1868,944,6158
5194,0,1493,3074,2638,1031,8236
5195,0,1635,3187,2690,1095,8607
5196,0,0,0,0,0,0
5197,0,864,1453,1219,552,4088
5198,0,552,1001,808,353,2714
5199,0,189,255,203,139,786
5200,0,125,274,236,103,738
5201,0,195,491,485,207,1378
5202,0,1770,2894,2422,1252,8338
5203,0,1381,2489,2158,1070,7098
5204,0,0,0,0,0,0
5205,0,1493,3074,2638,1031,8236
5206,0,1635,3187,2690,1095,8607
5207,0,654,1118,924,357,3053
5208,0,527,1280,1287,419,3513
5209,0,799,1305,1159,447,3710
5210,0,701,1309,1150,547,3707
5212,0,189,255,203,139,786
5213,0,34,139,138,55,366
5277,0,92,135,107,48,382
5215,0,2150,3532,3038,1855,10575
5216,0,1991,3613,2845,1912,10361
5217,0,16,78,29,30,153
5218,0,44,59,20,31,154
5219,0,487,909,874,332,2602
5220,0,1493,3074,2638,1031,8236
5221,0,1756,3379,2827,1164,9126
5222,6248,2325,3060,2220,1380,8985
5223,0,1041,2742,2552,1192,7527
5224,6248,1041,2742,2552,1192,7527
5225,0,2325,3060,2220,1380,8985
5226,0,1041,2742,2552,1192,7527
5227,0,2325,3060,2220,1380,8985
5228,0,864,1453,1219,552,4088
5229,0,552,1001,808,353,2714
5230,0,32,53,43,11,139
5231,0,18,35,31,12,96
5232,0,716,2115,1973,928,5732
5233,0,864,1453,1219,552,4088
5234,0,549,984,795,346,2674
5235,0,2325,3060,2220,1380,8985
5236,0,1577,3551,3180,1473,9781
5237,0,1602,2715,2339,1213,7869
5238,0,1194,2101,1830,921,6046
4417,0,209,433,366,164,1172
5008,0,216,353,287,140,996
5241,0,133,164,114,90,501
5242,0,241,612,504,227,1584
5243,0,799,1305,1159,447,3710
5244,0,701,1309,1150,547,3707
5245,0,1041,2742,2552,1192,7527
5246,0,2325,3060,2220,1380,8985
5247,0,1041,2742,2552,1192,7527
5248,0,2325,3060,2220,1380,8985
5249,0,6744,12513,9266,5371,33894
5250,0,1813,2204,1467,869,6353
5251,0,741,2185,2147,1000,6073
5252,0,5872,12064,9026,5304,32266
5253,0,2313,2885,2053,1315,8566
5254,0,246,315,213,94,868
5255,0,741,2185,2147,1000,6073
5256,0,1567,1889,1254,776,5486
5257,0,520,868,763,514,2665
5258,0,1041,2742,2552,1192,7527
5259,0,1813,2204,1467,869,6353
5260,0,350,517,392,230,1489
5261,0,241,612,504,227,1584
5262,0,628,1854,1757,853,5092
5263,0,1567,1889,1254,776,5486
5264,0,149,423,426,113,1111
5265,0,157,231,160,80,628
5266,0,2150,3532,3038,1855,10575
5267,0,393,586,439,251,1669
5268,9707,2163,4111,3261,2101,11636
5269,0,178,330,240,105,853
5270,0,82,299,296,88,765
5271,0,628,1854,1757,853,5092
5272,0,1567,1889,1254,776,5486
5273,0,1580,3200,2812,1111,8703
5274,8958,1756,3379,2827,1164,9126
5275,0,350,517,392,230,1489
5276,0,275,728,616,252,1871
5277,0,0,0,0,0,0
5277,0,45,72,50,22,189
5278,0,628,1854,1757,853,5092
5279,0,1567,1889,1254,776,5486
5280,0,129,286,276,111,802
5281,0,1228,2209,1925,934,6296
5282,0,1065,1815,1555,811,5246
5283,5732,1380,2550,2212,909,7051
5284,0,628,1854,1757,853,5092
5285,0,1400,2046,1625,902,5973
5286,0,1210,6456,2626,2878,13170
5288,0,318,697,684,204,1903
5289,0,654,1118,924,357,3053
5290,0,410,913,946,360,2629
5291,0,16,78,29,30,153
5292,0,44,59,20,31,154
5293,0,1270,2174,1748,812,6004
5294,0,1297,1640,1100,454,4491
5295,0,1106,1435,1182,826,4549
5296,0,275,728,616,252,1871
5297,0,393,586,439,251,1669
5298,0,5763,10935,3833,5544,26075
5299,0,1588,2336,1663,724,6311
5300,0,0,0,0,0,0
5301,0,16,78,29,30,153
5302,0,44,59,20,31,154
5303,0,0,0,0,0,0
5304,0,1023,2746,2442,1005,7216
5305,0,958,6304,2202,2783,12247
5306,0,0,0,0,0,0
5307,0,1297,1640,1100,454,4491
5308,0,383,1422,1628,586,4019
5309,0,0,0,0,0,0
5310,0,1297,1640,1100,454,4491
5311,8574,1297,1640,1100,454,4491
5312,0,9,15,12,4,40
5313,0,32,53,43,11,139
5314,0,23,49,45,19,136
5315,0,0,0,0,0,0
5316,0,3512,4764,1044,2600,11920
5317,8958,1580,3200,2812,1111,8703
5318,0,1756,3379,2827,1164,9126
5319,0,1042,972,638,338,2990
5320,0,1122,2190,1899,954,6165
5321,0,898,1900,1875,788,5461
5322,0,3652,5016,1483,2667,12818
5323,0,16,78,29,30,153
5324,0,44,59,20,31,154
5325,0,0,0,0,0,0
5326,0,1210,6456,2626,2878,13170
5327,0,799,1305,1159,447,3710
5328,0,701,1309,1150,547,3707
5329,0,498,176,68,170,912
5330,0,1201,2438,2109,731,6479
5331,0,1396,2652,2171,925,7144
5332,0,1053,1933,1696,839,5521
5333,0,1065,1815,1555,811,5246
5334,0,2960,12292,5158,5609,26019
5335,0,3652,5016,1483,2667,12818
5336,0,0,0,0,0,0
5337,0,5763,10935,3833,5544,26075
5338,0,1580,3200,2812,1111,8703
5339,0,1756,3379,2827,1164,9126
5340,0,2960,12292,5158,5609,26019
5341,0,1053,1933,1696,839,5521
5342,0,1065,1815,1555,811,5246
5343,0,475,742,620,281,2118
5344,0,410,913,946,360,2629
5345,0,97,289,112,140,638
5346,0,76,250,102,120,548
5347,0,380,356,204,109,1049
5348,0,230,254,171,78,733
5349,0,383,1422,1628,586,4019
5350,0,981,1520,1160,450,4111
5351,0,149,423,426,113,1111
5352,0,157,231,160,80,628
5353,0,706,1314,1150,414,3584
5354,0,1106,1435,1182,826,4549
5355,0,41,67,55,15,178
5356,0,23,49,45,19,136
5357,0,1588,2336,1663,724,6311
5359,0,97,289,112,140,638
5360,0,76,250,102,120,548
5361,0,1023,2746,2442,1005,7216
5362,0,475,742,620,281,2118
5363,0,410,913,946,360,2629
5364,0,799,1305,1159,447,3710
5365,0,1024,1502,1133,521,4180
5366,0,730,1722,1721,748,4921
5367,0,0,0,0,0,0
5368,0,1580,3200,2812,1111,8703
5369,0,1756,3379,2827,1164,9126
5370,0,16,78,29,30,153
5371,0,44,59,20,31,154
5372,0,0,0,0,0,0
5373,0,1210,6456,2626,2878,13170
5374,0,1772,2591,1946,1053,7362
5375,0,1723,3334,2934,1167,9158
5376,0,1047,2477,2420,878,6822
5377,0,685,935,665,315,2600
5011,0,203,375,304,160,1042
5378,0,449,990,968,413,2820
5379,0,1099,1681,1273,856,4909
5380,0,1699,2614,2177,901,7391
5381,0,2138,3968,3254,1189,10549
5382,0,744,1899,1807,644,5094
5383,0,491,1067,920,333,2811
5384,0,3652,5016,1483,2667,12818
5385,0,0,0,0,0,0
5386,0,1569,2372,1823,770,6534
5387,0,1047,2477,2420,878,6822
5388,0,322,395,279,113,1109
5389,0,1228,2166,1953,708,6055
5390,0,423,1507,1531,532,3993
5391,2705,68,134,76,70,348
5392,0,234,850,802,245,2131
5393,0,1108,1764,1504,528,4904
5394,0,423,1507,1531,532,3993
5395,0,614,1420,1527,564,4125
5396,3864,1024,1502,1133,521,4180
5397,0,1,279,231,0,511
5398,0,1108,1764,1504,528,4904
5399,0,423,1229,1300,531,3483
5400,0,333,965,946,416,2660
5401,0,714,991,690,328,2723
5402,9707,2440,3888,3278,2044,11650
5403,0,2163,4111,3261,2101,11636
5404,0,1107,1423,1057,527,4114
5405,0,423,1229,1300,531,3483
5406,0,1580,3200,2812,1111,8703
5407,0,1756,3379,2827,1164,9126
5408,0,160,257,186,113,716
5409,0,41,67,55,15,178
5410,0,105,313,158,83,659
5411,0,1102,1734,1326,773,4935
5412,0,449,990,968,413,2820
5413,0,505,1271,1315,483,3574
5414,0,1107,1423,1057,527,4114
5415,0,716,1644,1457,514,4331
5416,0,68,134,76,70,348
5417,0,234,850,802,245,2131
5418,0,958,6304,2202,2783,12247
5419,0,0,0,0,0,0
5420,0,1239,1800,1337,603,4979
5421,0,730,1722,1721,748,4921
5422,0,333,965,946,416,2660
5423,0,714,991,690,328,2723
5424,0,579,1238,1157,515,3489
5425,0,1099,1681,1273,856,4909
5426,0,1136,1984,1401,783,5304
5427,0,1217,2129,1868,944,6158
5428,0,0,0,0,0,0
5429,0,3512,4764,1044,2600,11920
5430,0,1239,1800,1337,603,4979
5431,0,730,1722,1721,748,4921
5432,0,1239,1800,1337,603,4979
5433,0,730,1722,1721,748,4921
5434,3864,614,1420,1527,564,4125
5435,0,1024,1502,1133,521,4180
5436,0,714,991,690,328,2723
5437,0,333,965,946,416,2660
5438,0,824,767,565,320,2476
5439,0,706,1314,1150,414,3584
5440,0,1061,1821,1695,982,5559
5441,0,621,1096,1013,667,3397
5442,0,685,935,665,315,2600
5443,0,16,78,29,30,153
5444,0,44,59,20,31,154
5445,0,614,1420,1527,564,4125
5446,0,641,923,680,314,2558
5447,0,383,579,453,207,1622
5448,0,1102,1734,1326,773,4935
5449,0,449,990,968,413,2820
5450,0,714,991,690,328,2723
5451,0,333,965,946,416,2660
5287,0,77,118,144,37,376
5452,0,475,742,620,281,2118
5453,0,333,797,805,324,2259
5454,0,0,0,0,0,0
5455,0,1210,6456,2626,2878,13170
5456,0,149,423,426,113,1111
5457,0,157,231,160,80,628
5458,0,579,1238,1157,515,3489
5459,2835,1099,1681,1273,856,4909
5460,0,1588,2336,1663,724,6311
5461,0,0,0,0,0,0
5462,0,1580,3200,2812,1111,8703
5463,0,1934,3620,3061,1282,9897
5464,0,286,500,462,229,1477
5465,0,456,886,841,384,2567
5466,0,333,965,946,416,2660
5467,0,1239,1800,1337,603,4979
5468,0,1053,1933,1696,839,5521
5469,0,1065,1815,1555,811,5246
5470,0,0,0,0,0,0
5471,0,1023,2746,2442,1005,7216
5472,0,3652,5016,1483,2667,12818
5473,0,0,0,0,0,0
5474,0,714,991,690,328,2723
5475,0,333,965,946,416,2660
5476,0,614,1420,1527,564,4125
5477,0,648,938,698,320,2604
5478,0,13,15,12,5,45
5479,0,304,255,176,109,844
5480,0,1569,2372,1823,770,6534
5481,0,743,2222,2244,768,5977
5482,0,16,78,29,30,153
5483,0,44,59,20,31,154
5484,0,149,423,426,113,1111
5485,0,157,231,160,80,628
5486,0,1239,1800,1337,603,4979
5487,0,730,1722,1721,748,4921
5488,0,1102,1734,1326,773,4935
5489,0,449,990,968,413,2820
5490,0,24,49,44,15,132
5491,0,178,330,240,105,853
5492,0,105,342,334,105,886
5493,0,0,0,0,0,0
5494,0,1210,6456,2626,2878,13170
5495,0,707,1416,1399,607,4129
5496,0,1136,1984,1401,783,5304
5497,0,1527,2520,2137,1065,7249
5498,0,407,970,1014,394,2785
5499,0,648,938,698,320,2604
5500,0,227,480,543,181,1431
5501,0,395,594,465,212,1666
5502,0,187,296,214,117,814
5503,0,105,313,158,83,659
5505,0,3652,5016,1483,2667,12818
5506,0,0,0,0,0,0
5507,0,1102,1734,1326,773,4935
5508,0,449,990,968,413,2820
5509,0,371,546,449,222,1588
5510,2835,579,1238,1157,515,3489
5511,0,1279,2090,1640,999,6008
5512,0,1715,3381,2996,1235,9327
5513,0,1934,3620,3061,1282,9897
5514,0,1488,2105,1460,641,5694
5515,0,630,1936,1721,539,4826
5516,0,382,830,1023,396,2631
5517,0,0,0,0,0,0
5518,0,1210,6456,2626,2878,13170
5519,0,407,970,1014,394,2785
5520,0,648,938,698,320,2604
5521,0,92,630,186,265,1173
5522,0,332,497,100,272,1201
5523,0,3652,5016,1483,2667,12818
5524,0,0,0,0,0,0
5525,0,333,965,946,416,2660
5526,0,714,991,690,328,2723
5527,0,363,1007,1057,425,2852
5528,0,714,991,690,328,2723
5529,0,164,300,246,103,813
5530,0,1588,2336,1663,724,6311
5531,0,227,480,543,181,1431
5532,0,395,594,465,212,1666
5533,0,506,585,374,162,1627
5534,0,1,4,3,1,9
5535,0,925,1589,1369,543,4426
5536,0,503,1607,1547,540,4197
5537,0,173,204,133,63,573
5538,0,1187,1661,1298,555,4701
5539,0,1108,1972,1844,1062,5986
5540,0,406,701,572,300,1979
5541,0,1238,2341,1842,973,6394
5542,0,1555,2492,2103,1097,7247
5543,0,1074,1371,927,390,3762
5544,0,621,1096,1013,667,3397
5545,0,454,1147,1048,489,3138
5547,0,725,1394,1101,267,3487
5548,0,491,1067,920,333,2811
5549,0,243,539,489,248,1519
5550,0,1102,1734,1326,773,4935
5551,0,462,931,859,369,2621
5552,0,958,6304,2202,2783,12247
5553,0,0,0,0,0,0
5554,0,958,6304,2202,2783,12247
5555,0,0,0,0,0,0
5556,0,447,728,566,257,1998
5557,0,407,970,1014,394,2785
5558,0,950,1609,1178,598,4335
5559,0,1053,1933,1696,839,5521
5560,0,1715,3381,2996,1235,9327
5561,0,1516,2882,2378,954,7730
5562,0,537,522,377,240,1676
5563,0,1181,1970,1499,542,5192
5564,0,639,2238,2142,683,5702
5565,0,714,991,690,328,2723
5566,0,333,965,946,416,2660
5567,0,227,480,543,181,1431
5568,0,395,594,465,212,1666
5569,0,0,0,0,0,0
5570,0,3512,4764,1044,2600,11920
5571,0,958,6304,2202,2783,12247
5572,0,850,1617,1447,671,4585
5573,0,1279,2090,1640,999,6008
5574,0,16,78,29,30,153
5575,0,44,59,20,31,154
5576,0,0,0,0,0,0
5577,0,3512,4764,1044,2600,11920
5578,0,149,423,426,113,1111
5579,0,576,679,462,265,1982
5580,0,233,407,597,283,1520
5581,0,187,296,214,117,814
5582,0,105,313,158,83,659
5583,0,3512,4764,1044,2600,11920
5584,0,258,229,141,77,705
5585,0,834,1667,1551,641,4693
5586,7518,894,1683,1321,645,4543
5587,0,1257,2296,1880,994,6427
5588,0,1555,2492,2103,1097,7247
5589,0,328,560,513,223,1624
5590,0,286,500,462,229,1477
5591,0,6564,12296,8836,5360,33056
5819,0,160,238,183,92,673
5592,0,203,379,284,120,986
5593,0,177,499,446,173,1295
5594,0,16,78,29,30,153
5595,0,44,59,20,31,154
5596,0,455,705,585,265,2010
5597,0,333,797,805,324,2259
5598,0,418,448,302,185,1353
5599,0,233,407,597,283,1520
5600,0,1285,2761,2454,934,7434
5601,0,1516,2882,2378,954,7730
5602,0,6390,14489,10249,6347,37475
5603,0,1257,2296,1880,994,6427
5604,4636,1555,2492,2103,1097,7247
5605,0,418,448,302,185,1353
5606,0,233,407,597,283,1520
5607,0,418,448,302,185,1353
5608,4417,170,296,504,254,1224
9017,0,63,111,93,29,296
5610,7518,978,1733,1533,655,4899
5611,0,894,1683,1321,645,4543
5612,0,1177,2818,2443,1117,7555
5613,0,1704,2680,2020,991,7395
5614,0,150,291,290,114,845
5615,0,164,300,246,103,813
5616,0,1704,2680,2020,991,7395
5617,0,1306,2773,2236,1273,7588
5618,0,485,1136,1002,306,2929
5619,0,1285,2761,2454,934,7434
5620,0,204,371,317,195,1087
5621,0,1406,2730,2233,841,7210
5622,0,875,1494,1210,643,4222
5623,0,462,931,859,369,2621
5624,0,6658,13228,9997,5890,35773
5625,4417,398,399,255,168,1220
5626,0,170,296,504,254,1224
5627,0,978,1733,1533,655,4899
5628,0,431,749,604,317,2101
5629,0,471,941,730,330,2472
5630,0,1563,2242,1604,644,6053
5631,0,639,2238,2142,683,5702
5632,0,85,96,64,34,279
5633,0,74,71,45,23,213
5634,0,1177,2818,2443,1117,7555
5635,0,1555,2532,1929,941,6957
5637,0,398,399,255,168,1220
5638,0,170,296,504,254,1224
5639,0,6658,13228,9997,5890,35773
5640,0,850,1617,1447,671,4585
5641,0,1279,2090,1640,999,6008
5642,0,398,399,255,168,1220
5643,0,329,728,898,425,2380
9017,0,267,351,257,133,1008
5644,0,16,78,29,30,153
5645,0,44,59,20,31,154
5646,0,665,750,513,301,2229
5647,0,206,536,588,210,1540
5648,0,3312,6058,4913,3187,17470
5649,0,2440,3888,3278,2044,11650
5650,0,850,1617,1447,671,4585
5651,0,1691,2505,1854,1171,7221
5652,0,150,291,290,114,845
5653,0,164,300,246,103,813
5654,0,1135,2663,2277,1048,7123
5655,0,1555,2532,1929,941,6957
5656,0,67,127,98,58,350
5657,0,1588,2336,1663,724,6311
5658,0,10,39,21,14,84
5659,0,6744,12513,9266,5371,33894
5660,0,45,95,82,44,266
5661,0,988,2690,2381,976,7035
5662,0,703,525,325,196,1749
5663,0,1135,2663,2277,1048,7123
5664,0,1693,3086,2731,1204,8714
5665,0,3512,4764,1044,2600,11920
5666,0,187,296,214,117,814
5667,4636,1257,2296,1880,994,6427
5668,0,1383,2225,1914,989,6511
5669,0,1357,1858,1425,616,5256
5670,0,1838,3188,2602,1244,8872
5671,0,967,1811,1464,461,4703
5672,0,1547,2826,2747,1647,8767
5673,0,227,480,543,181,1431
5674,0,395,594,465,212,1666
5675,0,903,1985,1778,653,5319
5676,0,967,1811,1464,461,4703
5677,0,903,1985,1778,653,5319
5678,0,967,1811,1464,461,4703
5679,0,143,154,104,50,451
5680,0,903,1985,1778,653,5319
5681,0,1013,2002,1686,532,5233
5682,0,202,473,480,222,1377
5683,0,16,78,29,30,153
5684,0,328,427,336,139,1230
5685,0,958,6304,2202,2783,12247
5686,0,80,108,70,28,286
5687,0,30,104,102,45,281
5688,0,30,104,102,45,281
5689,0,80,108,70,28,286
5690,0,3496,5385,4351,2677,15909
5691,0,2005,2640,1885,1049,7579
5692,0,1547,2826,2747,1647,8767
5693,0,1,4,2,1,8
5694,0,30,104,102,45,281
5695,0,82,112,73,29,296
5696,0,1057,1543,1195,481,4276
5697,0,1046,2139,1882,703,5770
5698,0,80,108,70,28,286
5699,0,481,1773,1693,325,4272
5700,0,1060,1301,924,646,3931
5701,0,689,1224,881,467,3261
5702,0,276,984,1051,440,2751
5703,0,567,666,435,204,1872
5704,0,31,108,105,46,290
5705,0,257,768,747,316,2088
5706,0,241,505,394,187,1327
5707,0,204,371,317,195,1087
5708,0,725,1394,1101,267,3487
5709,0,678,1102,1015,741,3536
5710,0,595,767,535,249,2146
5711,0,814,1784,1490,624,4712
5712,0,3512,4764,1044,2600,11920
5713,0,68,134,76,70,348
5714,0,234,850,802,245,2131
5715,0,1563,2242,1604,644,6053
5716,3747,639,2238,2142,683,5702
5717,0,1782,3394,2951,2123,10250
5718,0,1530,2664,1961,1064,7219
5719,0,875,1494,1210,643,4222
5720,0,462,931,859,369,2621
5721,0,227,480,543,181,1431
5722,0,395,594,465,212,1666
5723,0,958,6304,2202,2783,12247
5724,0,0,0,0,0,0
5725,0,1166,2012,1747,921,5846
5726,0,1383,2225,1914,989,6511
5727,0,0,0,0,0,0
5728,0,3512,4764,1044,2600,11920
5729,0,227,480,543,181,1431
5730,0,395,594,465,212,1666
5731,0,1138,2475,2231,830,6674
5732,0,1406,2730,2233,841,7210
5733,0,875,1494,1210,643,4222
5734,0,462,931,859,369,2621
5735,16414,1547,2826,2747,1647,8767
5736,0,2005,2640,1885,1049,7579
5737,0,988,2690,2381,976,7035
5738,0,249,508,454,194,1405
5739,0,1138,2475,2231,830,6674
5740,8015,1174,2260,1809,659,5902
5741,0,97,289,112,140,638
5742,0,76,250,102,120,548
5743,0,328,560,513,223,1624
5744,0,286,500,462,229,1477
5745,0,387,611,435,192,1625
5746,0,875,1494,1210,643,4222
5747,0,428,1021,1014,419,2882
5748,0,0,0,0,0,0
5749,0,1210,6456,2626,2878,13170
5750,0,3652,5016,1483,2667,12818
5751,0,0,0,0,0,0
5752,0,1558,2268,1602,702,6130
5753,0,315,530,389,180,1414
5754,0,177,499,446,173,1295
5755,0,1004,1230,841,363,3438
5756,0,1376,1987,1592,764,5719
5757,0,726,2233,2063,849,5871
5758,0,235,482,426,179,1322
5759,8015,881,1961,1807,650,5299
5760,0,1159,2216,1739,634,5748
5761,0,893,1260,794,324,3271
5762,0,276,984,1051,440,2751
5763,0,350,361,290,166,1167
5764,0,227,480,543,181,1431
5765,0,46,234,176,46,502
5766,0,551,653,413,177,1794
5767,0,1119,1850,1505,419,4893
5768,0,440,2008,2031,468,4947
5769,0,173,356,327,156,1012
5770,0,1005,1629,1270,626,4530
5771,0,255,664,687,264,1870
5772,0,893,1260,794,324,3271
5773,0,276,984,1051,440,2751
5774,0,1939,2428,1713,806,6886
5775,0,726,2233,2063,849,5871
5776,0,63,113,80,37,293
5777,0,46,234,176,46,502
5778,0,1166,2012,1747,921,5846
5779,0,1383,2225,1914,989,6511
5780,0,11,18,14,8,51
5781,0,10,20,13,7,50
5782,0,1939,2428,1713,806,6886
5783,0,726,2233,2063,849,5871
5784,0,2005,2640,1885,1049,7579
5785,0,606,2310,1755,538,5209
5786,0,336,363,218,122,1039
5787,0,893,1260,794,324,3271
5788,0,276,984,1051,440,2751
5789,0,3380,6158,5015,3644,18197
5790,0,150,291,290,114,845
5791,0,164,300,246,103,813
5792,0,201,352,254,130,937
5793,0,580,1355,1224,468,3627
5794,0,2404,5353,4632,2392,14781
5795,0,2657,4282,3587,2162,12688
5796,0,1805,2776,2362,1864,8807
5797,0,63,113,80,37,293
5798,0,46,234,176,46,502
6483,0,174,1037,908,180,2299
5799,0,22,25,19,7,73
5800,0,502,604,545,352,2003
5801,0,1031,1923,1607,805,5366
5802,0,838,1103,764,515,3220
5803,0,5726,11192,8072,4845,29835
5804,0,958,6304,2202,2783,12247
5805,0,0,0,0,0,0
5806,0,7531,13968,10434,6709,38642
5807,0,802,1835,1743,612,4992
5808,0,1159,2216,1739,634,5748
5809,0,279,1385,933,239,2836
5810,0,336,363,218,122,1039
5811,0,208,300,241,83,832
5812,0,150,291,290,114,845
5813,0,84,245,219,104,652
5814,0,7531,13968,10434,6709,38642
5815,0,0,0,0,0,0
5816,0,3512,4764,1044,2600,11920
5817,0,6658,13228,9997,5890,35773
5796,0,1598,2765,2064,1521,7948
5818,0,5933,11204,8370,5189,30696
5819,0,170,212,104,90,576
5820,0,328,560,513,223,1624
5821,0,355,696,640,336,2027
5822,0,2404,5353,4632,2392,14781
5823,0,2467,3577,2671,1340,10055
5824,0,1452,2081,1556,464,5553
5825,0,440,2008,2031,468,4947
5826,0,6390,14489,10249,6347,37475
5827,0,1845,2830,2085,1123,7883
5828,0,1306,2773,2236,1273,7588
5829,0,6744,12513,9266,5371,33894
5830,0,279,1385,933,239,2836
5831,5391,336,363,218,122,1039
5832,0,4288,9927,7432,3887,25534
5833,0,704,1429,1030,502,3665
5834,3747,1563,2242,1604,644,6053
5835,0,639,2238,2142,683,5702
5836,0,63,113,80,37,293
5837,0,46,234,176,46,502
5838,0,6744,12513,9266,5371,33894
5839,0,4992,11356,8462,4390,29200
5840,0,150,291,290,114,845
5841,0,164,300,246,103,813
5842,0,68,134,76,70,348
5843,0,234,850,802,245,2131
5844,0,4992,11356,8462,4390,29200
5845,0,92,630,186,265,1173
5846,0,332,497,100,272,1201
5847,0,893,1260,794,324,3271
5848,0,276,984,1051,440,2751
5849,0,7463,13868,10331,6253,37915
5850,0,792,1303,1028,522,3645
5851,0,255,664,687,264,1870
5852,0,1452,2081,1556,464,5553
5853,5391,279,1385,933,239,2836
5854,0,286,945,799,178,2208
5855,0,165,1119,1228,209,2721
5856,0,1845,2830,2085,1123,7883
5857,0,1306,2773,2236,1273,7588
5858,0,359,753,634,432,2178
5859,0,3021,5406,4382,3213,16022
5860,0,4462,7058,5949,4026,21495
5861,0,1845,2830,2085,1123,7883
5862,0,1306,2773,2236,1273,7588
5863,0,723,1704,1515,369,4311
5864,0,286,945,799,178,2208
5865,0,337,1718,1304,423,3782
5866,0,2067,3635,3329,1969,11000
5867,0,2467,3577,2671,1340,10055
5868,0,159,418,461,193,1231
5869,0,328,427,336,139,1230
5870,0,6658,13228,9997,5890,35773
5871,0,4633,10604,7828,3958,27023
5872,0,1563,2242,1604,644,6053
5873,0,639,2238,2142,683,5702
5874,0,723,1704,1515,369,4311
5875,0,286,945,799,178,2208
5876,0,683,1454,752,130,3019
5877,0,165,1119,1228,209,2721
5878,0,1166,2012,1747,921,5846
5879,0,1383,2225,1914,989,6511
5880,0,6744,12513,9266,5371,33894
5881,0,1845,2830,2085,1123,7883
5882,0,63,113,80,37,293
5883,0,1352,3007,2412,1319,8090
5884,0,1563,2242,1604,644,6053
5885,0,639,2238,2142,683,5702
5886,0,958,6304,2202,2783,12247
5887,0,7463,13868,10331,6253,37915
5888,0,723,1704,1515,369,4311
5889,0,286,945,799,178,2208
5890,0,2228,4263,3410,1566,11467
5891,0,1891,2545,2106,1143,7685
5892,0,2940,5102,4525,2569,15136
5893,37549,7463,13868,10331,6253,37915
5894,0,1166,2012,1747,921,5846
5895,0,1383,2225,1914,989,6511
5896,0,1109,1261,819,360,3549
5897,0,2764,4013,3302,1744,11823
5898,0,723,1704,1515,369,4311
5900,0,4430,8964,6588,4324,24306
5901,0,1939,2428,1713,806,6886
5902,0,723,1704,1515,369,4311
5903,0,984,3210,2992,1125,8311
5904,0,893,1260,794,324,3271
5905,0,1648,3201,2732,802,8383
5906,0,276,981,984,440,2681
5907,0,3512,4764,1044,2600,11920
5908,0,2376,4189,3305,1126,10996
5909,0,1358,2316,1852,980,6506
5910,0,873,1468,1196,601,4138
5911,0,63,113,80,37,293
5912,0,46,234,176,46,502
5913,0,4633,10604,7828,3958,27023
5914,0,2846,4308,3471,2446,13071
5916,0,286,945,799,178,2208
5917,0,1272,1908,1425,650,5255
5918,0,716,2176,1826,412,5130
5919,0,902,2546,2313,921,6682
5920,0,165,270,153,0,588
5921,0,828,2888,2657,852,7225
5922,12150,828,2888,2657,852,7225
5923,12150,2376,4189,3305,1126,10996
5924,0,683,1454,752,130,3019
5925,0,165,1119,1228,209,2721
5926,0,7479,14910,11299,6404,40092
5927,0,7463,13868,10331,6253,37915
5928,0,2048,3566,2892,1311,9817
5929,0,4695,8946,6374,4059,24074
5930,0,137,157,114,73,481
5931,0,7463,13868,10331,6253,37915
5932,0,792,1303,1028,522,3645
5933,0,255,664,687,264,1870
5934,0,828,2888,2657,852,7225
5935,0,1558,2268,1602,702,6130
5936,0,113,157,89,66,425
5937,0,68,134,76,70,348
5938,0,2376,4189,3305,1126,10996
5939,0,498,771,618,312,2199
5940,0,355,696,640,336,2027
5941,0,1166,2012,1747,921,5846
5942,0,1383,2225,1914,989,6511
5943,0,7463,13868,10331,6253,37915
5944,0,215,420,405,109,1149
5945,0,1166,2012,1747,921,5846
5946,0,1206,1976,1731,907,5820
6736,0,113,158,90,67,428
5947,0,0,1,1,0,2
5948,0,1048,2876,2489,1047,7460
5949,0,164,293,271,217,945
5950,0,1062,1842,1693,816,5413
5951,0,1510,2341,2007,1055,6913
5952,0,1188,2062,1901,1006,6157
5953,0,1510,2341,2007,1055,6913
5954,43583,7479,14910,11299,6404,40092
5955,8347,828,2888,2657,852,7225
5956,0,802,1120,695,348,2965
5957,0,6661,12748,9636,5905,34950
5958,0,2940,5102,4525,2569,15136
5959,0,1188,2062,1901,1006,6157
5960,5559,1510,2341,2007,1055,6913
5961,0,2102,4562,2817,2460,11941
5962,0,3758,5629,4919,3524,17830
5963,0,3000,3806,2925,1503,11234
5964,0,3021,5406,4382,3213,16022
5965,8347,2209,3472,2579,950,9210
5966,0,802,1835,1743,612,4992
5967,0,1159,2216,1739,634,5748
5968,0,1621,2476,1773,680,6550
5969,0,902,2546,2313,921,6682
5970,0,413,599,464,259,1735
5971,0,213,349,337,0,899
5972,0,67,192,173,280,712
5973,0,828,2888,2657,852,7225
5974,0,1909,2943,2165,1159,8176
5975,0,1352,3007,2412,1319,8090
5976,0,1426,2085,1490,571,5572
5977,0,2209,3472,2579,950,9210
5978,0,703,2213,2063,682,5661
5979,0,683,1454,752,130,3019
5980,0,165,1119,1228,209,2721
5981,0,7479,14910,11299,6404,40092
5982,0,75,159,136,56,426
5983,0,498,771,618,312,2199
5984,0,280,540,509,280,1609
5985,0,4430,8964,6588,4324,24306
5986,0,137,157,114,73,481
5987,0,665,962,582,275,2484
5988,0,1621,2476,1773,680,6550
5989,0,902,2546,2313,921,6682
5990,0,2231,3784,3048,1581,10644
5991,0,4430,8964,6588,4324,24306
5992,0,2571,3251,2264,979,9065
5993,0,483,2009,1877,521,4890
5994,0,880,2853,2707,1000,7440
5995,0,6661,12748,9636,5905,34950
5996,0,1128,2280,1727,541,5676
5997,0,429,373,214,125,1141
5998,0,1619,3193,2678,1186,8676
5999,0,72,167,156,64,459
6000,0,1214,6732,2642,2975,13563
6001,0,6661,12748,9636,5905,34950
6002,0,483,2009,1877,521,4890
6003,0,2236,3353,2819,1733,10141
6004,0,1134,2123,1920,962,6139
6005,0,7256,13520,10048,6037,36861
6006,0,3000,3806,2925,1503,11234
6007,0,2561,4575,3673,1978,12787
6008,0,683,1454,752,130,3019
6009,0,165,1119,1228,209,2721
6010,0,958,6304,2202,2783,12247
6011,0,0,0,0,0,0
6012,0,3652,5016,1483,2667,12818
6013,0,77,442,173,160,852
6014,0,335,500,259,191,1285
6015,0,792,1303,1028,522,3645
6016,0,802,1835,1743,612,4992
6017,0,723,1465,1103,298,3589
6018,0,434,877,818,376,2505
6019,0,1214,6732,2642,2975,13563
6020,0,0,0,0,0,0
6021,0,1214,6732,2642,2975,13563
6022,0,0,0,0,0,0
6023,0,0,0,0,0,0
6024,0,3512,4764,1044,2600,11920
6025,0,0,0,0,0,0
6026,0,1214,6732,2642,2975,13563
6027,0,0,0,0,0,0
6028,0,463,1318,1145,266,3192
6029,0,0,0,0,0,0
6030,0,1214,6732,2642,2975,13563
6031,39341,7256,13520,10048,6037,36861
6032,38298,6661,12748,9636,5905,34950
6033,0,1214,6732,2642,2975,13563
6034,0,0,0,0,0,0
6035,0,6661,12748,9636,5905,34950
6036,0,483,2009,1877,521,4890
6037,0,3,6,5,2,16
6038,0,241,505,394,187,1327
6039,0,207,377,322,197,1103
6040,0,0,0,0,0,0
6041,0,3813,5204,1468,2751,13236
6042,0,0,0,0,0,0
6043,0,3813,5204,1468,2751,13236
6044,0,315,530,389,180,1414
6045,0,0,1,3,0,4
6046,0,390,844,778,173,2185
6047,0,0,0,0,0,0
6048,0,3813,5204,1468,2751,13236
6049,0,6661,12748,9636,5905,34950
6050,0,463,1318,1145,266,3192
6051,0,0,0,0,0,0
6052,0,3813,5204,1468,2751,13236
6053,0,3325,5027,3779,1749,13880
6054,0,2753,5316,4598,2148,14815
6055,0,3813,5204,1468,2751,13236
6056,0,0,0,0,0,0
6057,0,0,0,0,0,0
6058,0,1214,6732,2642,2975,13563
6059,0,7256,13520,10048,6037,36861
6060,0,7479,14910,11299,6404,40092
6061,0,455,705,585,265,2010
6062,5559,1188,2062,1901,1006,6157
6063,0,1724,2780,2410,1286,8200
6064,0,1621,2476,1773,680,6550
6065,0,902,2546,2313,921,6682
6066,0,793,1671,1533,591,4588
6067,0,723,1465,1103,298,3589
6068,0,223,1390,1251,366,3230
6069,0,260,619,626,155,1660
6070,0,2404,3013,2128,966,8511
6071,0,880,2853,2707,1000,7440
6072,0,3813,5204,1468,2751,13236
6073,0,0,0,0,0,0
6074,0,178,587,290,203,1258
6075,0,335,500,259,191,1285
6076,0,6661,12748,9636,5905,34950
6077,0,159,418,461,193,1231
6078,0,328,427,336,139,1230
6079,0,256,428,440,192,1316
6080,0,302,440,424,151,1317
6081,0,958,6304,2202,2783,12247
6082,0,6661,12748,9636,5905,34950
6083,0,463,1318,1145,266,3192
6084,0,7256,13520,10048,6037,36861
6085,0,159,418,461,193,1231
6086,0,328,427,336,139,1230
6087,0,3813,5204,1468,2751,13236
6088,0,0,0,0,0,0
6089,0,7256,13520,10048,6037,36861
6090,0,2753,5316,4598,2148,14815
6091,0,3325,5027,3779,1749,13880
6092,0,413,599,461,259,1732
6093,0,67,192,173,280,712
6094,0,260,619,626,155,1660
6095,0,1671,2424,1691,768,6554
6096,0,793,1671,1533,591,4588
6097,0,723,1465,1103,298,3589
6098,0,683,1454,752,130,3019
6099,0,165,1119,1228,209,2721
6100,0,0,0,0,0,0
6101,0,958,6304,2202,2783,12247
6102,0,1621,2476,1773,680,6550
6103,0,902,2546,2313,921,6682
6104,0,164,249,173,85,671
6105,0,84,245,219,104,652
6106,0,3512,4764,1044,2600,11920
6107,0,0,0,0,0,0
6108,0,793,1671,1533,591,4588
6109,0,723,1465,1103,298,3589
6110,0,92,630,186,265,1173
6111,0,332,497,100,272,1201
6112,0,544,927,733,320,2524
6113,0,434,877,818,376,2505
6114,0,1621,2476,1773,680,6550
6115,0,902,2546,2313,921,6682
6116,0,958,6304,2202,2783,12247
6117,19848,5867,9713,7852,5659,29091
6118,0,2404,3013,2128,966,8511
6119,0,880,2853,2707,1000,7440
6120,0,3325,5027,3779,1749,13880
6121,0,683,1454,752,130,3019
6122,0,165,1119,1228,209,2721
6123,0,5861,10190,7736,5984,29771
6124,13469,2753,5316,4598,2148,14815
6125,0,3512,4764,1044,2600,11920
6126,0,793,1671,1533,591,4588
6127,0,723,1465,1103,298,3589
6128,25634,5763,10935,3833,5544,26075
6129,0,793,1671,1533,591,4588
6130,0,723,1465,1103,298,3589
6131,0,108,174,159,80,521
6132,0,244,511,399,189,1343
6133,0,99,203,162,117,581
6134,0,92,630,186,265,1173
6135,0,332,497,100,272,1201
6136,24744,2960,12292,5158,5609,26019
6137,0,1909,2943,2165,1159,8176
6138,0,1352,3007,2412,1319,8090
6139,0,793,1671,1533,591,4588
6140,0,723,1465,1103,298,3589
6141,0,159,418,461,193,1231
6142,0,328,427,336,139,1230
6143,0,315,527,387,180,1409
6144,0,390,844,778,173,2185
6145,0,544,927,733,320,2524
6146,0,434,877,818,376,2505
6147,0,463,1318,1145,266,3192
6148,0,0,0,0,0,0
6149,0,793,1671,1533,591,4588
6150,0,723,1465,1103,298,3589
6151,0,793,1671,1533,591,4588
6152,0,723,1465,1103,298,3589
6153,0,83,329,345,177,934
6154,6320,129,459,504,109,1201
6155,0,131,162,122,46,461
6156,0,149,263,176,108,696
6157,0,99,203,162,117,581
6158,0,2404,3013,2128,966,8511
6159,0,880,2853,2707,1000,7440
6160,0,178,587,290,203,1258
6161,0,335,500,259,191,1285
6162,0,1524,2410,2084,1178,7196
6163,0,3073,4532,3668,2018,13291
6164,0,1302,2678,2301,1340,7621
6165,6320,380,989,800,90,2259
6166,0,576,806,620,258,2260
6167,0,793,1671,1533,591,4588
6168,7451,1013,2331,1920,640,5904
6169,19848,5861,10190,7736,5984,29771
6170,0,5867,9713,7852,5659,29091
6171,0,544,927,733,320,2524
6172,0,434,877,818,376,2505
6173,0,164,249,173,85,671
6174,0,84,245,219,104,652
6175,0,129,459,504,109,1201
6176,0,486,732,580,270,2068
6177,7451,1369,2478,2152,849,6848
6178,0,1228,2914,2486,882,7510
6179,0,683,1454,752,130,3019
6180,0,165,1119,1228,209,2721
6181,0,92,630,186,265,1173
6182,0,332,497,100,272,1201
6183,0,5861,10190,7736,5984,29771
6184,0,796,870,594,351,2611
6185,0,1909,2943,2165,1159,8176
6186,0,790,2614,2128,1109,6641
6187,0,159,418,461,193,1231
6188,0,328,427,336,139,1230
6189,0,307,588,504,217,1616
6190,0,544,927,733,320,2524
6191,0,394,821,728,342,2285
6192,0,1771,3011,2551,1060,8393
6193,0,1228,2914,2486,882,7510
6194,0,380,989,800,90,2259
6195,0,6327,10746,8687,6019,31779
6212,0,964,1377,988,552,3881
6196,0,2182,3973,3429,2065,11649
6197,7664,2900,4502,3841,2059,13302
6198,0,5861,10190,7736,5984,29771
6199,0,840,2022,1635,450,4947
6200,0,149,263,176,108,696
6201,0,99,203,162,117,581
6202,0,1276,2138,1850,792,6056
6203,0,5181,9067,7341,5336,26925
6204,0,5473,9298,6885,5552,27208
6205,0,1771,3011,2551,1060,8393
6206,0,315,527,387,180,1409
6207,0,2298,3764,3269,2026,11357
6208,0,2844,4604,3989,2072,13509
6209,0,1771,3011,2551,1060,8393
6210,0,1228,2914,2486,882,7510
6211,13469,3325,5027,3779,1749,13880
6213,7664,2298,3764,3269,2026,11357
6214,0,2900,4502,3841,2059,13302
6215,0,2753,5316,4598,2148,14815
6216,0,3325,5027,3779,1749,13880
6217,0,1228,2914,2486,882,7510
6218,0,1771,3011,2551,1060,8393
6219,0,1621,2476,1773,680,6550
6220,0,902,2546,2313,921,6682
6221,0,164,249,173,85,671
6222,0,84,245,219,104,652
6223,0,3325,5027,3779,1749,13880
6224,0,0,0,0,0,0
6225,0,159,418,461,193,1231
6226,0,328,427,336,139,1230
6227,0,92,630,186,265,1173
6228,0,660,924,436,410,2430
6229,0,159,418,461,193,1231
6230,0,1771,3011,2551,1060,8393
6231,0,1228,2914,2486,882,7510
6232,0,149,263,176,108,696
6233,0,99,203,162,117,581
6234,0,1228,2914,2486,882,7510
6235,0,1771,3011,2551,1060,8393
6236,0,3325,5027,3779,1749,13880
6237,0,683,1454,752,130,3019
6238,0,165,1119,1228,209,2721
6239,0,2167,3549,3026,2046,10788
6240,0,2844,4604,3989,2072,13509
6241,0,1993,2867,2213,1186,8259
6242,0,1302,2678,2301,1340,7621
6243,0,178,587,290,203,1258
6244,0,335,500,259,191,1285
6483,0,604,390,296,333,1623
6245,0,2149,4926,4302,1814,13191
6246,0,1797,2455,1537,902,6691
6247,0,790,2614,2128,1109,6641
6248,0,251,1047,647,458,2403
6249,0,660,924,436,410,2430
6250,0,413,355,227,123,1118
6251,0,2404,3013,2128,966,8511
6252,0,651,2741,2734,991,7117
6253,0,2167,3549,3026,2046,10788
6254,0,2844,4604,3989,2072,13509
6255,0,2167,3549,3026,2046,10788
6256,0,2844,4604,3989,2072,13509
6257,0,164,249,173,85,671
6258,0,84,245,219,104,652
6259,0,491,848,674,288,2301
6260,0,394,821,728,342,2285
6261,0,413,599,461,259,1732
6262,0,2167,3549,3026,2046,10788
6263,0,2661,4401,3799,2005,12866
6264,0,546,821,611,303,2281
6265,0,1993,2867,2213,1186,8259
6266,0,888,2132,1907,1122,6049
6267,0,2330,3753,3124,1958,11165
6268,0,2553,3775,3112,1834,11274
6269,0,309,1043,994,335,2681
6270,0,131,162,122,46,461
6271,0,83,330,345,177,935
6272,0,0,0,0,0,0
6273,0,11,18,14,8,51
6274,0,10,20,13,7,50
6275,0,3325,5027,3779,1749,13880
6276,0,251,1047,647,458,2403
6277,0,660,924,436,410,2430
6278,0,77,99,42,44,262
6279,0,251,1047,647,458,2403
6280,0,582,826,394,367,2169
6281,0,2018,3326,2791,1857,9992
6282,0,2553,3775,3112,1834,11274
6283,0,1621,2476,1773,680,6550
6284,0,902,2546,2313,921,6682
6285,0,315,466,379,188,1348
6286,0,2018,3326,2791,1857,9992
6287,0,2612,3897,3243,1914,11666
6288,0,2171,3509,2937,1934,10551
6289,0,2612,3897,3243,1914,11666
6290,0,1671,2424,1691,768,6554
6291,0,0,0,0,0,0
6292,0,0,0,0,0,0
6293,0,1048,2876,2489,1047,7460
6294,0,491,848,674,288,2301
6295,0,394,821,728,342,2285
6296,0,2149,4926,4302,1814,13191
6297,0,227,926,581,406,2140
6298,0,582,826,394,367,2169
6299,0,149,263,176,108,696
6300,0,2171,3509,2937,1934,10551
6301,0,2462,3634,3068,1806,10970
6302,0,2072,3306,2775,1817,9970
6303,0,2462,3634,3068,1806,10970
6304,0,227,926,581,406,2140
6305,0,571,808,381,361,2121
6306,0,11,18,12,6,47
6307,0,683,1454,752,130,3019
6308,0,165,1119,1228,209,2721
6309,0,125,226,177,78,606
6310,0,2072,3306,2775,1817,9970
6311,0,2337,3408,2891,1728,10364
6312,0,328,427,336,139,1230
6313,0,159,418,461,193,1231
6314,0,1966,3106,2627,1732,9431
6315,0,2337,3408,2891,1728,10364
6316,0,164,249,173,85,671
6317,0,222,330,179,115,846
6318,0,110,483,250,182,1025
6319,0,1966,3106,2627,1732,9431
6320,4464,2337,3408,2891,1728,10364
6321,0,328,427,336,139,1230
6322,0,159,418,461,193,1231
6323,0,1797,2455,1537,902,6691
6324,3987,790,2614,2128,1109,6641
6325,0,1621,2476,1773,680,6550
6326,0,902,2546,2313,921,6682
6327,0,491,848,674,288,2301
6328,4464,1966,3106,2627,1732,9431
6329,0,1257,1584,1336,806,4983
6330,0,1164,2188,1930,1022,6304
6331,0,11,18,14,8,51
6332,0,10,20,13,7,50
6333,0,221,907,567,399,2094
6334,0,571,808,381,361,2121
6335,0,513,844,639,265,2261
6336,0,309,1043,994,335,2681
6337,0,1671,2424,1691,768,6554
6338,0,0,0,0,0,0
6339,0,328,427,336,139,1230
6340,0,159,418,461,193,1231
6341,0,0,0,0,0,0
6342,8815,1048,2876,2489,1047,7460
6343,0,126,422,201,140,889
6344,0,222,330,179,115,846
6345,0,221,907,567,399,2094
6346,0,571,808,381,361,2121
6347,0,159,418,461,193,1231
6348,0,328,427,336,139,1230
6349,3987,1797,2455,1537,902,6691
6350,0,790,2614,2128,1109,6641
6351,0,615,1220,1356,898,4089
6352,0,1257,1584,1336,806,4983
6353,0,3325,5027,3779,1749,13880
6354,0,178,587,290,203,1258
6355,0,335,500,259,191,1285
6356,0,513,844,639,265,2261
6357,0,309,1043,994,335,2681
6358,0,683,1454,752,130,3019
6359,0,165,1119,1228,209,2721
6360,0,328,427,336,139,1230
6361,0,159,418,461,193,1231
6362,0,2492,2888,1894,910,8184
6363,0,0,1,0,0,1
6364,0,651,2740,2734,991,7116
6365,0,615,1220,1356,898,4089
6366,0,1257,1584,1336,806,4983
6367,0,1797,2455,1537,902,6691
6368,0,790,2614,2128,1109,6641
6369,0,6,19,14,8,47
6370,0,11,18,12,6,47
6371,0,2149,4926,4302,1814,13191
6372,0,178,587,290,203,1258
6373,0,335,500,259,191,1285
6374,0,615,1220,1356,898,4089
6375,0,1257,1584,1336,806,4983
6376,0,126,422,201,140,889
6377,0,222,330,179,115,846
6378,0,683,1454,752,130,3019
6379,0,145,832,916,181,2074
6380,0,760,923,959,457,3099
6381,0,1423,2090,1399,560,5472
6382,0,460,1580,1540,503,4083
6383,0,287,395,182,139,1003
6384,0,110,483,250,182,1025
6385,0,1621,2476,1773,680,6550
6386,0,1173,2351,1722,685,5931
6387,0,723,2311,2201,722,5957
6388,0,1214,1652,1450,864,5180
6389,0,749,1309,1381,900,4339
6390,0,0,0,0,0,0
6391,2436,760,923,959,457,3099
6392,0,5968,10172,7586,5820,29546
6393,0,749,1309,1381,900,4339
6394,0,2922,3548,2579,1154,10203
6395,0,599,1247,1343,924,4113
6396,0,3208,3598,2364,1196,10366
6397,0,5092,11077,9691,5629,31489
6398,0,615,1220,1356,898,4089
6399,3211,1257,1584,1336,806,4983
6400,0,287,395,182,139,1003
6401,0,110,483,250,182,1025
6402,8815,1671,2424,1691,768,6554
6403,0,126,422,201,140,889
6404,0,222,330,179,115,846
6405,0,221,907,567,399,2094
6406,0,571,808,381,361,2121
6407,0,513,844,639,265,2261
6408,0,309,1043,994,335,2681
6409,0,450,945,777,338,2510
6410,0,0,0,0,0,0
6411,0,97,289,112,140,638
6412,0,76,250,102,120,548
6414,0,178,587,290,203,1258
6415,0,335,500,259,191,1285
6416,0,1048,2876,2489,1047,7460
6417,0,717,710,470,286,2183
6418,0,2491,2888,1894,910,8183
6419,0,797,3307,3478,1259,8841
6420,0,0,0,0,0,0
6421,0,760,923,959,457,3099
6422,0,1287,1893,1246,544,4970
6423,0,1022,2029,1626,593,5270
6424,0,537,1743,1595,539,4414
6425,3211,615,1220,1356,898,4089
6426,0,1257,1584,1336,806,4983
6427,0,287,395,182,139,1003
6428,0,110,483,250,182,1025
6429,0,126,422,201,140,889
6430,0,222,330,179,115,846
6431,2436,450,945,777,338,2510
6432,0,0,0,0,0,0
6433,0,1671,2424,1691,768,6554
6434,0,516,699,444,439,2098
6435,0,287,395,182,139,1003
6436,1311,110,483,250,182,1025
6437,0,467,582,425,193,1667
6438,0,749,1270,1085,676,3780
6439,0,1123,3165,2357,1290,7935
6440,0,3325,5027,3779,1749,13880
6441,0,450,945,777,338,2510
6442,0,724,1341,1153,479,3697
6443,0,1214,1652,1450,864,5180
6444,0,749,1309,1381,900,4339
6445,0,1592,2563,1757,573,6485
6446,0,723,2311,2201,722,5957
6447,0,126,422,201,140,889
6448,0,222,330,179,115,846
6449,0,1532,2277,1591,881,6281
6450,0,1164,2188,1930,1022,6304
6451,0,126,422,201,140,889
6452,0,222,330,179,115,846
6453,0,367,515,367,163,1412
6454,0,615,1220,1356,898,4089
6455,0,1214,1652,1450,864,5180
6456,0,1797,2455,1537,902,6691
6457,0,790,2614,2128,1109,6641
6458,0,775,1443,934,674,3826
6459,0,749,1270,1085,676,3780
6460,0,749,1270,1085,676,3780
6461,0,775,1443,934,674,3826
6462,0,1027,1929,1575,709,5240
6463,0,1220,2225,1953,856,6254
6464,0,1847,4454,3917,1586,11804
6465,0,1674,2213,1604,934,6425
6466,0,888,2132,1907,1122,6049
6467,0,775,1443,934,674,3826
6468,0,749,1270,1085,676,3780
6469,0,749,1309,1381,900,4339
6470,0,1214,1652,1450,864,5180
6471,0,126,422,201,140,889
6472,0,222,330,179,115,846
6473,0,1214,1732,1204,488,4638
6474,0,537,1743,1595,539,4414
6475,0,1214,1652,1450,864,5180
6476,0,749,1309,1381,900,4339
6477,1311,287,395,182,139,1003
6478,0,110,483,250,182,1025
6479,0,1221,2341,1989,858,6409
6480,0,1220,2225,1953,856,6254
6481,0,126,422,201,140,889
6482,0,222,330,179,115,846
6483,0,400,636,474,194,1704
6484,0,1221,2341,1989,858,6409
6485,0,939,1831,1661,753,5184
6486,0,1592,2563,1757,573,6485
6487,4547,723,2311,2201,722,5957
6488,0,1720,2541,1711,1014,6986
6489,0,1123,3165,2357,1290,7935
6490,0,126,422,201,140,889
6491,0,222,330,179,115,846
6492,0,1214,1732,1204,488,4638
6493,0,537,1743,1595,539,4414
6494,0,7825,12130,8753,6086,34794
6495,0,0,0,0,0,0
6496,0,0,0,0,0,0
6497,0,221,907,567,399,2094
6498,0,571,808,381,361,2121
6499,0,513,844,639,265,2261
6500,0,309,1043,994,335,2681
6501,0,1094,1942,1615,699,5350
6502,0,939,1831,1661,753,5184
6503,22798,5092,11077,9691,5629,31489
6504,0,6,19,14,8,47
6505,0,11,18,12,6,47
6506,0,287,395,182,139,1003
6507,0,92,435,173,154,854
6508,0,85,203,163,84,535
6509,0,7825,12130,8753,6086,34794
6510,0,2712,4462,3175,1399,11748
6511,0,6,19,14,8,47
6512,0,11,18,12,6,47
6513,0,1797,2455,1537,902,6691
6514,0,790,2614,2128,1109,6641
6515,0,1532,2277,1591,881,6281
6516,0,1164,2188,1930,1022,6304
6517,0,1720,2541,1711,1014,6986
6518,0,1123,3165,2357,1290,7935
6519,0,210,404,332,177,1123
6520,0,126,422,201,140,889
6521,0,376,617,406,192,1591
6522,0,1094,1942,1615,699,5350
6523,0,939,1831,1661,753,5184
6524,12365,1847,4454,3917,1586,11804
6525,0,251,359,136,128,874
6526,0,92,435,173,154,854
6527,0,1674,2213,1604,934,6425
6528,3138,888,2132,1907,1122,6049
6529,4547,1592,2563,1757,573,6485
6530,0,198,457,398,182,1235
6531,0,525,1854,1803,540,4722
6532,0,1214,1732,1204,488,4638
6533,0,537,1743,1595,539,4414
6534,0,97,289,112,140,638
6535,0,76,250,102,120,548
6536,3138,1674,2213,1604,934,6425
6537,0,888,2132,1907,1122,6049
6538,0,1094,1942,1615,699,5350
6539,0,939,1831,1661,753,5184
6540,0,1212,1698,1241,767,4918
6541,0,759,1806,1416,882,4863
6542,0,659,1275,1238,599,3771
6543,0,1674,2213,1604,934,6425
6544,0,759,1806,1416,882,4863
6545,0,1212,1698,1241,767,4918
6546,0,759,1806,1416,882,4863
6547,0,1094,1942,1615,699,5350
6548,0,939,1831,1661,753,5184
6549,0,5092,11077,9691,5629,31489
6550,0,313,489,395,191,1388
6551,0,198,457,398,182,1235
6552,0,1094,1942,1615,699,5350
6553,0,939,1831,1661,753,5184
6554,0,221,907,567,399,2094
6555,0,571,808,381,361,2121
6556,0,251,359,136,128,874
6557,0,92,435,173,154,854
6558,0,1720,2541,1711,1014,6986
6559,0,1123,3165,2357,1290,7935
6560,0,1279,2074,1362,382,5097
6561,0,525,1854,1803,540,4722
6562,0,1214,1732,1204,488,4638
6563,0,537,1743,1595,539,4414
6564,0,649,1401,1322,593,3965
6565,0,1094,1942,1615,699,5350
6566,0,433,736,533,278,1980
6567,0,1212,1698,1241,767,4918
6568,0,759,1806,1416,882,4863
6569,0,1720,2541,1711,1014,6986
6570,0,1123,3165,2357,1290,7935
6571,0,345,778,696,321,2140
6572,0,433,736,533,278,1980
6573,0,513,844,639,265,2261
6574,0,832,2168,2189,825,6014
6575,0,901,1619,1300,456,4276
6576,0,775,1443,934,674,3826
6577,0,749,1270,1085,676,3780
6578,0,5763,10935,3833,5544,26075
6579,0,1339,2048,1535,674,5596
6580,0,832,2168,2189,825,6014
6581,0,1797,2455,1537,902,6691
6582,0,284,444,329,139,1196
6583,0,790,2766,2180,1201,6937
6584,12601,2712,4462,3175,1399,11748
6585,0,345,778,696,321,2140
6586,0,433,736,533,278,1980
6587,0,251,359,136,128,874
6588,0,92,435,173,154,854
6589,0,113,417,367,146,1043
6590,0,284,444,329,139,1196
6591,0,1946,3445,2853,1301,9545
6592,3593,1086,1922,1469,665,5142
6593,0,1163,2322,2027,961,6473
6594,0,1896,3433,2864,1347,9540
6595,0,1946,3445,2853,1301,9545
6596,0,1896,3433,2864,1347,9540
6597,0,1946,3445,2853,1301,9545
6598,0,178,587,290,203,1258
6599,0,335,500,259,191,1285
6600,0,1896,3433,2864,1347,9540
6601,0,1946,3445,2853,1301,9545
6602,0,2960,12292,5158,5609,26019
6603,0,1720,2541,1711,1014,6986
6604,0,1123,3165,2357,1290,7935
6605,0,598,1539,1601,537,4275
6606,0,901,1619,1300,456,4276
6607,0,1532,2277,1591,881,6281
6608,0,1896,3433,2864,1347,9540
6609,0,566,1503,1592,526,4187
6610,0,598,1539,1601,537,4275
6611,0,901,1619,1300,456,4276
6612,0,1847,4454,3917,1586,11804
6613,0,884,1581,1265,430,4160
6614,0,566,1503,1592,526,4187
6615,0,83,183,163,73,502
6616,0,884,1581,1265,430,4160
6617,0,598,1539,1601,537,4275
6618,0,1339,2048,1535,674,5596
6619,3648,832,2168,2189,825,6014
6620,0,345,778,696,321,2140
6621,0,433,736,533,278,1980
6622,0,901,1619,1300,456,4276
6623,0,598,1539,1601,537,4275
6624,0,598,1539,1601,537,4275
6625,0,901,1619,1300,456,4276
6626,0,345,778,696,321,2140
6627,0,433,736,533,278,1980
6628,0,1025,2094,1810,730,5659
6629,0,1152,2126,1680,756,5714
6630,0,1152,2126,1680,756,5714
6631,0,1025,2094,1810,730,5659
6632,3593,868,1895,1659,668,5090
6633,0,1086,1922,1469,665,5142
6634,0,113,417,367,146,1043
6635,0,284,444,329,139,1196
6636,0,345,778,696,321,2140
6637,0,433,736,533,278,1980
6638,0,868,1895,1659,668,5090
6639,0,1086,1922,1469,665,5142
6640,0,313,489,395,191,1388
6641,0,198,457,398,182,1235
6642,0,868,1895,1659,668,5090
6643,0,1086,1922,1469,665,5142
6644,0,868,1895,1659,668,5090
6645,0,1086,1922,1469,665,5142
6646,0,1279,2074,1362,382,5097
6647,0,953,1865,1666,831,5315
6648,0,1666,3802,3259,1254,9981
6649,0,221,907,567,399,2094
6650,0,571,808,381,361,2121
6651,0,270,419,331,138,1158
6652,0,868,1895,1659,668,5090
6653,0,1152,2126,1680,756,5714
6654,0,1152,2126,1680,756,5714
6655,0,1025,2094,1810,730,5659
6656,0,178,587,290,203,1258
6657,0,251,359,136,128,874
6658,0,84,141,123,63,411
6659,0,1025,2094,1810,730,5659
6660,0,1152,2126,1680,756,5714
6661,0,1152,2126,1680,756,5714
6662,0,1025,2094,1810,730,5659
6663,0,345,778,696,321,2140
6664,0,433,736,533,278,1980
6665,0,92,435,173,154,854
6666,0,251,359,136,128,874
6667,0,113,417,367,146,1043
6668,0,284,444,329,139,1196
6669,0,267,671,475,249,1662
6670,0,376,617,406,192,1591
6671,0,1214,1732,1204,488,4638
6672,0,537,1743,1595,539,4414
6673,22798,7825,12130,8753,6086,34794
6674,0,1025,2094,1810,730,5659
6675,0,950,1781,1421,745,4897
6676,0,1377,2776,2419,903,7475
6677,0,1213,2261,1988,985,6447
6678,0,4748,10249,8470,5343,28810
6679,0,448,579,420,218,1665
6680,0,113,417,367,146,1043
6681,0,345,778,696,321,2140
6682,0,345,778,696,321,2140
6683,0,433,736,533,278,1980
6684,0,1141,1948,1457,714,5260
6685,0,953,1865,1666,831,5315
6686,0,313,489,395,191,1388
6687,0,900,1772,1593,794,5059
6688,0,1295,2428,1766,857,6346
6689,0,1720,2541,1711,1014,6986
6690,0,1123,3165,2357,1290,7935
6691,0,1295,2428,1766,857,6346
6692,0,1213,2261,1988,985,6447
6693,0,103,191,132,66,492
6694,0,85,203,163,84,535
6695,0,251,359,136,128,874
6696,0,92,435,173,154,854
6697,0,1141,1948,1457,714,5260
6698,0,953,1865,1666,831,5315
6699,0,92,435,173,154,854
6700,0,251,359,136,128,874
6701,0,2232,3940,3028,1212,10412
6702,0,1097,1971,1368,675,5111
6703,0,693,2191,2096,659,5639
6704,0,1213,2261,1988,985,6447
6705,0,1295,2428,1766,857,6346
6706,0,2712,4462,3175,1399,11748
6707,0,6,19,14,8,47
6708,0,11,18,12,6,47
6709,0,1213,2261,1988,985,6447
6710,0,1295,2428,1766,857,6346
6711,0,1847,4454,3917,1586,11804
6712,3648,1339,2048,1535,674,5596
6713,0,832,2168,2189,825,6014
6714,0,1967,2633,1551,987,7138
6715,4698,790,2766,2180,1201,6937
6716,0,1295,2428,1766,857,6346
6717,0,1213,2261,1988,985,6447
6718,0,728,1382,1216,539,3865
6719,0,1141,1948,1457,714,5260
6720,0,1036,2153,1784,840,5813
6721,0,2960,12292,5158,5609,26019
6722,0,1212,1698,1241,767,4918
6723,0,759,1806,1416,882,4863
6724,0,1720,2541,1711,1014,6986
6725,0,1123,3165,2357,1290,7935
6726,0,5763,10935,3833,5544,26075
6727,0,1720,2541,1711,1014,6986
6728,0,1123,3165,2357,1290,7935
6729,0,0,0,0,0,0
6730,0,0,0,0,0,0
6731,0,267,671,475,249,1662
6732,0,376,617,406,192,1591
6733,0,742,1722,1638,745,4847
6734,0,1339,2048,1535,674,5596
6735,0,255,816,783,204,2058
6736,0,124,172,129,62,487
6737,0,1212,1698,1241,767,4918
6738,0,826,1979,1565,946,5316
6739,0,1214,1732,1204,488,4638
6740,0,1171,2173,1646,765,5755
6741,0,1059,2792,2481,1035,7367
6742,0,103,191,132,66,492
6743,0,85,203,163,84,535
6744,0,406,795,642,441,2284
6745,0,484,858,719,489,2550
6746,0,204,419,375,185,1183
6747,0,1431,2360,1825,913,6529
6748,0,484,858,719,489,2550
6749,0,578,1247,1086,363,3274
6750,0,1720,2541,1711,1014,6986
6751,0,1123,3165,2357,1290,7935
6752,0,2960,12292,5158,5609,26019
6753,0,1720,2541,1711,1014,6986
6754,0,1123,3165,2357,1290,7935
6755,0,883,1317,986,381,3567
6756,0,578,1247,1086,363,3274
6757,0,1327,1862,1358,825,5372
6758,0,826,1979,1565,946,5316
6759,0,1871,2802,1953,908,7534
6760,0,1059,2792,2481,1035,7367
6761,0,0,0,0,0,0
6762,0,4748,10249,8470,5343,28810
6763,0,7271,11102,7884,5902,32159
6764,0,0,0,0,0,0
6765,0,385,608,440,200,1633
6766,0,255,816,783,204,2058
6767,0,267,671,475,249,1662
6768,0,376,617,406,192,1591
6769,0,1720,2541,1711,1014,6986
6770,0,1123,3165,2357,1290,7935
6771,0,221,907,567,399,2094
6772,0,571,808,381,361,2121
6773,0,103,191,132,66,492
6774,0,85,203,163,84,535
6775,0,1871,2802,1953,908,7534
6776,0,1059,2792,2481,1035,7367
6777,0,775,1443,934,674,3826
6778,0,461,694,556,452,2163
6779,3865,288,576,529,225,1618
6780,0,1327,1862,1358,825,5372
6781,0,399,804,543,480,2226
6782,0,428,1175,1022,466,3091
6783,0,385,608,440,200,1633
6784,0,255,816,783,204,2058
6785,0,2712,4462,3175,1399,11748
6786,0,1871,2802,1953,908,7534
6787,0,1414,3149,2768,1322,8653
6788,13837,1799,4735,4065,1542,12141
6789,0,7271,11102,7884,5902,32159
6790,0,6,19,14,8,47
6791,0,11,18,12,6,47
6792,0,4748,10249,8470,5343,28810
6793,3865,376,639,391,193,1599
6794,0,866,1168,802,373,3209
6795,0,716,1751,1551,690,4708
6796,0,1457,2528,1639,498,6122
6797,0,693,2191,2096,659,5639
6798,0,92,435,173,154,854
6799,0,251,359,136,128,874
6800,0,5763,10935,3833,5544,26075
6801,0,221,907,567,399,2094
6802,0,571,808,381,361,2121
6803,0,1242,1807,1193,566,4808
6804,0,614,1675,1649,647,4585
6805,0,229,350,228,114,921
6806,0,38,76,32,27,173
6807,0,34,94,57,35,220
6808,0,251,359,136,128,874
6809,0,92,435,173,154,854
6810,0,2960,12292,5158,5609,26019
6811,0,385,608,440,200,1633
6812,0,255,816,783,204,2058
6813,0,34,94,57,35,220
6814,0,38,76,32,27,173
6815,0,34,94,57,35,220
6816,0,38,76,32,27,173
6817,0,92,435,173,154,854
6818,0,251,359,136,128,874
6819,0,47,61,31,22,161
6820,0,14,156,51,24,245
6821,0,221,907,567,399,2094
6822,0,571,808,381,361,2121
6823,0,6,19,14,8,47
6824,0,11,18,12,6,47
6825,0,103,191,132,66,492
6826,0,85,203,163,84,535
6827,0,267,671,475,249,1662
6828,0,363,558,356,168,1445
6829,0,14,156,51,24,245
6830,0,406,795,642,441,2284
6831,0,484,858,719,489,2550
6832,0,385,608,440,200,1633
6833,0,255,816,783,204,2058
6834,0,34,94,57,35,220
6835,0,38,76,32,27,173
6836,0,38,76,32,27,173
6837,0,34,94,57,35,220
6838,0,1457,2528,1639,498,6122
6839,3633,693,2191,2096,659,5639
6840,4698,1967,2633,1551,987,7138
6841,0,790,2766,2180,1201,6937
6843,7091,1414,3149,2768,1322,8653
6844,0,217,765,764,238,1984
6845,0,221,707,444,227,1599
6846,0,823,1217,713,309,3062
6847,0,374,1349,1115,421,3259
6848,2908,823,1217,713,309,3062
6849,0,1720,2541,1711,1014,6986
6850,0,1123,3165,2357,1290,7935
6851,0,1874,3075,2331,1172,8452
6853,0,38,76,32,27,173
6854,0,34,94,57,35,220
6855,0,374,1349,1115,421,3259
6856,0,823,1217,713,309,3062
6857,0,34,94,57,35,220
6858,0,38,76,32,27,173
6859,0,47,61,31,22,161
6860,0,14,156,51,24,245
6861,13837,3016,4828,3231,1378,12453
6862,0,1799,4735,4065,1542,12141
6863,0,6,19,14,8,47
6864,0,11,18,12,6,47
6865,0,221,907,567,399,2094
6866,0,571,808,381,361,2121
6867,0,93,136,97,39,365
6868,0,254,557,518,207,1536
6869,0,406,795,642,441,2284
6870,0,719,1270,1039,637,3665
6871,0,7271,11102,7884,5902,32159
6872,0,4748,10249,8470,5343,28810
6873,0,385,608,440,200,1633
6874,0,255,816,783,204,2058
6875,0,554,1054,916,426,2950
6876,0,897,2243,1956,942,6038
6877,0,34,94,57,35,220
6878,0,38,76,32,27,173
6879,0,1239,1649,1155,527,4570
6880,0,614,1675,1649,647,4585
6881,0,34,94,57,35,220
6882,0,38,76,32,27,173
6883,0,646,1189,998,460,3293
6884,7091,1874,3075,2331,1172,8452
6885,0,37,148,104,47,336
6887,0,897,2243,1956,942,6038
6888,0,34,94,57,35,220
6889,0,38,76,32,27,173
6890,0,1409,2143,1507,767,5826
6892,0,604,1189,1019,593,3405
6893,0,719,1270,1039,637,3665
6894,0,14,156,51,24,245
6895,0,47,61,31,22,161
6896,0,1967,2633,1551,987,7138
6897,2908,374,1349,1115,421,3259
6898,0,859,2453,1745,1009,6066
6900,0,897,2243,1956,942,6038
6901,0,1409,2143,1507,767,5826
6903,0,5763,10935,3833,5544,26075
6904,0,604,1189,1019,593,3405
6905,0,719,1270,1039,637,3665
6906,0,103,191,132,66,492
6907,0,34,94,57,35,220
6908,0,51,110,106,50,317
6909,0,7271,11102,7884,5902,32159
6910,0,604,1189,1019,593,3405
6911,0,4445,9244,7541,5189,26419
6905,0,582,1450,1260,491,3783
6912,0,21,151,69,21,262
6913,0,47,61,31,22,161
6914,0,12,49,19,18,98
6915,0,385,608,440,200,1633
6916,0,255,816,783,204,2058
6918,0,897,2243,1956,942,6038
6919,0,2960,12292,5158,5609,26019
6920,0,1239,1649,1155,527,4570
6921,0,614,1675,1649,647,4585
6922,0,1409,2143,1507,767,5826
6924,0,86,152,118,49,405
6925,0,0,0,0,0,0
6926,0,84,141,123,63,411
6927,0,38,76,32,27,173
6928,0,29,48,31,22,130
6929,0,27,99,38,37,201
6930,0,221,907,567,399,2094
6931,2735,571,808,381,361,2121
6932,0,883,1317,986,381,3567
6933,0,578,1247,1086,363,3274
6934,0,11,18,14,8,51
6935,0,33,213,64,92,402
6936,0,116,185,48,98,447
6937,0,1720,2541,1711,1014,6986
6938,0,1123,3165,2357,1290,7935
6939,0,255,816,783,204,2058
6940,0,385,608,440,200,1633
6941,0,125,384,420,94,1023
6942,0,385,608,440,200,1633
6943,0,129,432,363,110,1034
6944,0,883,1317,986,381,3567
6945,0,578,1247,1086,363,3274
6946,0,434,788,794,371,2387
6947,0,6,19,14,8,47
6948,522,532,835,741,325,2433
6949,0,3016,4828,3231,1378,12453
6950,0,1799,4735,4065,1542,12141
6951,0,385,608,440,200,1633
6952,1559,255,816,783,204,2058
6953,3633,1457,2528,1639,498,6122
6954,0,693,2191,2096,659,5639
6955,0,1239,1649,1155,527,4570
6956,0,614,1675,1649,647,4585
6957,0,109,173,37,95,414
6958,0,33,213,64,92,402
6959,0,41,223,75,96,435
6960,0,116,185,48,98,447
6961,0,255,816,783,204,2058
6962,1559,385,608,440,200,1633
6963,0,41,223,75,96,435
6964,0,116,185,48,98,447
6965,0,897,2243,1956,942,6038
6966,0,1409,2143,1507,767,5826
6967,0,530,1428,1096,571,3625
6968,0,838,1270,816,479,3403
6969,0,6560,9775,7168,5695,29198
6970,0,4445,9244,7541,5189,26419
6971,0,1720,2541,1711,1014,6986
6972,0,1123,3165,2357,1290,7935
6973,0,1588,2453,1517,906,6464
6974,0,838,1270,816,479,3403
6975,0,905,2779,2090,1325,7099
6976,0,883,1317,986,381,3567
6977,0,578,1247,1086,363,3274
6978,0,146,344,316,141,947
6979,0,1457,2528,1639,498,6122
6980,0,619,1995,1885,573,5072
6981,0,200,325,251,66,842
6982,0,3016,4828,3231,1378,12453
6983,0,1936,5068,4345,1627,12976
6984,0,129,432,363,110,1034
6985,0,229,350,228,114,921
6986,0,65,115,100,39,319
6987,0,51,110,106,50,317
6988,0,41,223,75,96,435
6989,0,116,185,48,98,447
6990,0,65,115,100,39,319
6991,0,51,110,106,50,317
6992,0,76,138,106,52,372
6993,0,883,1317,986,381,3567
6994,0,641,1388,1202,421,3652
6995,0,229,350,228,114,921
6996,0,129,432,363,110,1034
6997,0,1720,2541,1711,1014,6986
6998,0,1123,3165,2357,1290,7935
6999,2735,221,907,567,399,2094
7000,0,571,808,381,361,2121
7001,0,65,115,100,39,319
7002,0,51,110,106,50,317
7003,0,41,223,75,96,435
7004,0,116,185,48,98,447
7005,0,129,432,363,110,1034
7006,0,229,350,228,114,921
7007,0,6560,9775,7168,5695,29198
7008,0,0,0,0,0,0
7009,0,0,0,0,0,0
7010,21092,4445,9244,7541,5189,26419
7011,0,3216,5154,3482,1444,13296
7012,0,1936,5068,4345,1627,12976
7013,0,530,1428,1096,571,3625
7014,0,838,1270,816,479,3403
7015,0,1315,2316,1485,439,5555
7016,0,619,1995,1885,573,5072
7017,0,5763,10935,3833,5544,26075
7018,0,2960,12292,5158,5609,26019
7019,0,897,2243,1956,942,6038
7020,0,65,115,100,39,319
7021,0,51,110,106,50,317
7022,0,1409,2143,1507,767,5826
7023,0,1940,2620,1584,1130,7274
7024,0,905,2779,2090,1325,7099
7025,0,0,0,0,0,0
7026,0,530,1428,1096,571,3625
7027,0,838,1270,816,479,3403
7028,0,1239,1649,1155,527,4570
7029,0,614,1675,1649,647,4585
7030,522,441,807,809,379,2436
7031,0,532,835,741,325,2433
7032,0,109,173,37,95,414
7033,685,33,213,64,92,402
7034,0,5763,10935,3833,5544,26075
7035,0,2960,12292,5158,5609,26019
7036,0,41,223,75,96,435
7037,0,116,185,48,98,447
7038,0,530,1428,1096,571,3625
7039,0,838,1270,816,479,3403
7040,0,65,115,100,39,319
7041,0,51,110,106,50,317
7042,0,1239,1649,1155,527,4570
7043,0,614,1675,1649,647,4585
7044,21092,6560,9775,7168,5695,29198
7045,0,0,0,0,0,0
7047,0,0,0,0,0,0
7048,0,4445,9244,7541,5189,26419
7049,0,3201,4630,2015,2231,12077
7050,0,3201,4630,2015,2231,12077
7051,0,3201,4630,2015,2231,12077
7053,0,897,2243,1956,942,6038
7054,0,530,1428,1096,571,3625
7055,0,838,1270,816,479,3403
7056,0,187,384,424,173,1168
7057,0,41,223,75,96,435
7058,0,400,552,368,223,1543
7059,0,1409,2143,1507,767,5826
7061,0,1236,5186,2661,2261,11344
7062,0,3201,4630,2015,2231,12077
7063,0,1236,5186,2661,2261,11344
7064,0,3201,4630,2015,2231,12077
7065,0,0,0,0,0,0
7066,0,1236,5186,2661,2261,11344
7067,685,109,173,37,95,414
7068,0,33,213,64,92,402
7069,0,530,1428,1096,571,3625
7070,0,838,1270,816,479,3403
7071,0,0,0,0,0,0
7072,0,0,0,0,0,0
7073,0,1236,5186,2661,2261,11344
7074,0,47,81,25,34,187
7075,0,27,99,38,37,201
7076,0,696,964,791,428,2879
7077,0,1720,2541,1711,1014,6986
7078,0,791,2832,2063,1108,6794
7079,0,1236,5186,2661,2261,11344
7081,5949,897,2243,1956,942,6038
7082,0,280,618,573,260,1731
7083,0,530,1428,1096,571,3625
7084,0,1121,1716,1162,619,4618
7085,0,3216,5154,3482,1444,13296
7086,0,1936,5068,4345,1627,12976
7087,0,454,1114,1200,474,3242
7088,0,1239,1649,1155,527,4570
7089,0,303,853,621,288,2065
7090,0,1315,2316,1485,439,5555
7091,0,619,1995,1885,573,5072
7092,0,1409,2143,1507,767,5826
7094,0,1664,2170,1203,813,5850
7095,0,791,2832,2063,1108,6794
7096,0,497,781,510,264,2052
7097,0,303,853,621,288,2065
7098,0,710,1844,1531,750,4835
7099,5949,1409,2143,1507,767,5826
7100,0,245,510,504,236,1495
7101,0,497,781,510,264,2052
7102,0,303,853,621,288,2065
7103,0,3201,4630,2015,2231,12077
7104,0,1940,2620,1584,1130,7274
7105,0,905,2779,2090,1325,7099
7106,0,221,907,567,399,2094
7107,0,3201,4630,2015,2231,12077
7108,0,0,0,0,0,0
7109,0,1236,5186,2661,2261,11344
7110,0,65,115,100,39,319
7111,0,287,431,354,165,1237
7112,0,258,518,521,248,1545
7113,0,0,0,0,0,0
7114,0,0,0,0,0,0
7115,0,1236,5186,2661,2261,11344
7116,0,221,907,567,399,2094
7117,0,1016,4278,2095,1861,9250
7118,0,409,1244,1062,132,2847
7119,0,958,1455,1092,433,3938
7120,0,734,1650,1259,290,3933
7121,0,497,781,510,264,2052
7122,0,303,853,621,288,2065
7123,0,3216,5154,3482,1444,13296
7124,0,1936,5068,4345,1627,12976
7125,0,6560,9775,7168,5695,29198
7126,0,2630,3822,1634,1870,9956
7127,0,212,583,476,260,1531
7128,0,400,552,368,223,1543
7129,0,2630,3822,1634,1870,9956
7131,0,4445,9244,7541,5189,26419
7132,0,2630,3822,1634,1870,9956
7133,0,1315,2316,1485,439,5555
7134,0,619,1995,1885,573,5072
7135,0,3201,4630,2015,2231,12077
7136,0,1016,4278,2095,1861,9250
7137,0,0,0,0,0,0
7138,0,0,0,0,0,0
7139,0,2630,3822,1634,1870,9956
7141,0,1016,4278,2095,1861,9250
7142,0,1016,4278,2095,1861,9250
7143,0,2630,3822,1634,1870,9956
7145,0,497,781,510,264,2052
7146,0,303,853,621,288,2065
7147,0,1236,5186,2661,2261,11344
7148,0,2630,3822,1634,1870,9956
7149,0,1664,2170,1203,813,5850
7150,0,791,2832,2063,1108,6794
7151,0,2630,3822,1634,1870,9956
7152,0,1016,4278,2095,1861,9250
7154,0,1315,2316,1485,439,5555
7155,0,619,1995,1885,573,5072
7156,0,1016,4278,2095,1861,9250
7157,0,897,1734,1309,261,4201
7158,0,734,1650,1259,290,3933
7159,13894,3201,4630,2015,2231,12077
7160,0,1016,4278,2095,1861,9250
7161,0,897,1734,1309,261,4201
7162,0,734,1650,1259,290,3933
7163,0,1236,5186,2661,2261,11344
7164,0,1940,2620,1584,1130,7274
7165,0,905,2779,2090,1325,7099
7166,0,2630,3822,1634,1870,9956
7167,0,1664,2170,1203,813,5850
7168,0,791,2832,2063,1108,6794
7169,0,207,409,415,198,1229
7170,0,287,431,354,165,1237
7171,0,497,781,510,264,2052
7172,0,303,853,621,288,2065
7173,0,109,173,37,95,414
7174,0,33,213,64,92,402
7175,0,130,70,24,102,326
7176,0,1940,2620,1584,1130,7274
7177,0,842,2866,2125,1292,7125
7178,0,1016,4278,2095,1861,9250
7179,0,1991,2687,1475,1104,7257
7180,0,842,2866,2125,1292,7125
7181,0,6560,9775,7168,5695,29198
7182,0,5763,10935,3833,5544,26075
7183,0,346,538,425,191,1500
7184,0,245,510,504,236,1495
7185,0,0,0,0,0,0
7186,0,0,0,0,0,0
7187,0,1991,2687,1475,1104,7257
7188,0,842,2866,2125,1292,7125
7189,0,1315,2316,1485,439,5555
7190,0,619,1995,1885,573,5072
7191,0,47,81,25,34,187
7192,0,27,99,38,37,201
7193,0,352,546,454,204,1556
7194,0,258,518,521,248,1545
7195,0,2960,12292,5158,5609,26019
7196,0,441,807,809,379,2436
7197,0,2630,3822,1634,1870,9956
7198,0,45,110,82,40,277
7199,0,3216,5154,3482,1444,13296
7200,12539,1936,5068,4345,1627,12976
7201,0,897,1734,1309,261,4201
7202,0,734,1650,1259,290,3933
7203,0,1991,2687,1475,1104,7257
7204,0,559,2203,1433,990,5185
7205,0,288,672,700,305,1965
7206,0,376,705,738,339,2158
7207,0,685,3683,1439,1562,7369
7208,0,1493,1992,948,881,5314
7209,0,559,2203,1433,990,5185
7210,0,86,152,118,49,405
7211,146,84,141,123,63,411
7212,0,47,81,25,34,187
7213,0,27,99,38,37,201
7214,0,497,781,510,264,2052
7215,0,303,853,621,288,2065
7216,0,3201,4630,2015,2231,12077
7217,0,503,705,535,226,1969
7218,0,288,672,700,305,1965
7219,0,897,1734,1309,261,4201
7220,0,734,1650,1259,290,3933
7221,0,346,538,425,191,1500
7222,0,245,510,504,236,1495
7223,13894,1236,5186,2661,2261,11344
7224,0,0,0,0,0,0
7225,685,0,0,0,0,0
7226,0,234,528,649,277,1688
7227,0,1493,1992,948,881,5314
7228,0,374,1794,818,767,3753
7229,0,47,81,25,34,187
7230,0,27,99,38,37,201
7231,0,6560,9775,7168,5695,29198
7232,0,937,2283,1509,827,5556
7233,0,2208,3199,1046,1625,8078
7234,0,497,781,510,264,2052
7235,0,303,853,621,288,2065
7236,0,207,409,415,198,1229
7237,0,287,431,354,165,1237
7238,0,122,176,127,52,477
7239,0,3404,5050,2422,2396,13272
7240,0,1792,3286,2292,2415,9785
7241,0,4389,9308,7031,4270,24998
7242,0,2257,4395,3365,2535,12552
7243,0,897,1734,1309,261,4201
7244,0,734,1650,1259,290,3933
7245,0,685,3683,1439,1562,7369
7246,0,1049,1454,530,732,3765
7247,0,374,1794,818,767,3753
7248,0,493,751,634,274,2152
7249,0,1236,5186,2661,2261,11344
7250,0,326,597,534,217,1674
7251,0,5763,10935,3833,5544,26075
7253,0,1315,2316,1485,439,5555
7254,0,680,1886,1678,601,4845
7255,0,140,650,564,102,1456
6910,0,690,1519,955,387,3551
7256,0,1664,2170,1203,813,5850
7257,0,791,2832,2063,1108,6794
7258,0,3404,5050,2422,2396,13272
7259,0,5705,8771,6386,4107,24969
7260,0,897,1734,1309,261,4201
7261,0,278,533,530,266,1607
7262,12539,3216,5154,3482,1444,13296
7263,0,1936,5068,4345,1627,12976
7264,0,466,1153,854,20,2493
7265,0,4200,8688,6707,4516,24111
7266,0,1550,5583,3009,2400,12542
7267,0,342,659,644,310,1955
7268,0,352,546,454,204,1556
7269,146,86,152,118,49,405
7270,0,346,538,425,191,1500
7271,0,245,510,504,236,1495
7272,0,497,781,510,264,2052
7273,0,303,853,621,288,2065
7274,0,2208,3199,1046,1625,8078
7275,0,3216,5154,3482,1444,13296
7276,0,1936,5068,4345,1627,12976
7277,0,1664,2170,1203,813,5850
7278,0,500,1348,1164,478,3490
7279,0,505,1930,1161,802,4398
7280,0,2208,3199,1046,1625,8078
7281,0,685,3683,1439,1562,7369
7282,0,2208,3199,1046,1625,8078
7283,0,2208,3199,1046,1625,8078
7284,0,0,0,0,0,0
7285,0,0,0,0,0,0
7286,0,685,3683,1439,1562,7369
7287,0,685,3683,1439,1562,7369
7288,0,1034,1525,906,472,3937
7289,0,500,1348,1164,478,3490
7290,0,3404,5050,2422,2396,13272
7291,0,685,3683,1439,1562,7369
7292,0,47,81,25,34,187
7293,0,1049,1454,530,732,3765
7294,0,385,1881,846,797,3909
7295,0,31,46,25,23,125
7296,0,98,165,120,55,438
7297,0,3056,5462,3637,3204,15359
7298,0,2233,4382,3365,2532,12512
7299,0,3216,5154,3482,1444,13296
7300,0,1936,5068,4345,1627,12976
7301,0,503,705,535,226,1969
7302,0,0,0,0,0,0
7303,0,288,672,700,305,1965
7304,0,1550,5583,3009,2400,12542
7305,0,0,0,0,0,0
7306,0,31,46,25,23,125
7307,0,20,57,27,19,123
7309,0,346,538,425,191,1500
7310,0,245,510,504,236,1495
7311,0,3404,5050,2422,2396,13272
7312,0,844,1092,559,513,3008
7313,0,505,1930,1161,802,4398
7314,0,4200,8688,6707,4516,24111
7315,0,503,705,535,226,1969
7316,0,20,57,27,19,123
7317,0,319,718,726,327,2090
7318,0,5679,8236,6113,4326,24354
7319,0,31,46,25,23,125
7320,0,20,57,27,19,123
7321,0,2208,3199,1046,1625,8078
7322,0,31,46,25,23,125
7323,0,20,57,27,19,123
7324,0,685,3683,1439,1562,7369
7325,0,5763,10935,3833,5544,26075
7326,0,1550,5583,3009,2400,12542
7327,685,0,0,0,0,0
7328,0,0,0,0,0,0
7329,0,844,1092,559,513,3008
7330,0,505,1930,1161,802,4398
7331,0,523,762,562,246,2093
7332,0,319,718,726,327,2090
7333,0,3216,5154,3482,1444,13296
7334,0,1936,5068,4345,1627,12976
7335,0,2960,12292,5158,5609,26019
7336,0,5763,10935,3833,5544,26075
7337,0,346,538,425,191,1500
7338,0,245,510,504,236,1495
7339,0,1093,1513,542,761,3909
7340,3217,385,1881,846,797,3909
7341,0,31,46,25,23,125
7342,0,20,57,27,19,123
7343,0,31,46,25,23,125
7344,0,20,57,27,19,123
7345,0,20,57,27,19,123
7346,0,31,46,25,23,125
7347,0,3404,5050,2422,2396,13272
7348,0,1187,2199,1299,524,5209
7349,0,680,1886,1678,601,4845
7350,0,2960,12292,5158,5609,26019
7351,0,1034,1525,906,472,3937
7352,0,500,1348,1164,478,3490
7354,0,3053,5445,3627,3191,15316
7355,0,2233,4382,3365,2532,12512
7356,0,5679,8236,6113,4326,24354
7357,0,0,0,0,0,0
7358,0,1550,5583,3009,2400,12542
7359,0,0,0,0,0,0
7360,0,4200,8688,6707,4516,24111
7361,0,3404,5050,2422,2396,13272
7363,0,346,538,425,191,1500
7364,0,245,510,504,236,1495
7365,0,1034,1525,906,472,3937
7366,0,500,1348,1164,478,3490
7367,0,3321,7479,2309,3865,16974
7368,0,3404,5050,2422,2396,13272
7369,0,1550,5583,3009,2400,12542
7371,0,3404,5050,2422,2396,13272
7373,0,1550,5583,3009,2400,12542
7374,0,1034,1525,906,472,3937
7375,0,500,1348,1164,478,3490
7376,0,3404,5050,2422,2396,13272
7378,0,1550,5583,3009,2400,12542
7379,0,2442,3457,1524,1678,9101
7380,0,963,1593,898,717,4171
7381,0,1034,1525,906,472,3937
7382,0,500,1348,1164,478,3490
7383,0,346,538,425,191,1500
7384,0,245,510,504,236,1495
7385,0,52,65,10,36,163
7386,0,109,173,37,95,414
7387,0,43,305,90,128,566
7388,0,1550,5583,3009,2400,12542
7389,0,1034,1525,906,472,3937
7390,0,500,1348,1164,478,3490
7391,0,1034,1525,906,472,3937
7392,0,500,1348,1164,478,3490
7393,0,2107,8648,3124,4084,17963
7394,0,853,3644,2035,1525,8057
7395,0,1446,5331,2935,2264,11976
7396,0,654,1372,554,636,3216
7397,0,497,781,510,264,2052
7398,0,1034,1525,906,472,3937
7399,5842,659,1909,1612,651,4831
7400,0,0,0,0,0,0
7401,0,0,0,0,0,0
7402,0,523,762,562,246,2093
7403,0,319,718,726,327,2090
7404,0,3321,7479,2309,3865,16974
7405,0,498,993,262,620,2373
7406,0,3216,5154,3482,1444,13296
7407,0,1936,5068,4345,1627,12976
7408,0,844,1092,559,513,3008
7409,6009,505,1930,1161,802,4398
7410,0,685,3683,1439,1562,7369
7411,5842,1387,2013,1243,621,5264
7412,0,543,1567,1235,521,3866
7413,0,116,341,378,130,965
7414,0,2107,8648,3124,4084,17963
7415,0,0,0,0,0,0
7416,0,0,0,0,0,0
7417,0,523,762,562,246,2093
7418,0,319,718,726,327,2090
7419,0,212,583,476,260,1531
7420,1195,400,552,368,223,1543
7421,0,1460,2586,1160,1338,6544
7422,0,3053,5445,3627,3191,15316
7423,0,2233,4382,3365,2532,12512
7424,0,2098,6704,3490,2900,15192
7425,0,1087,1650,993,520,4250
7426,0,543,1567,1235,521,3866
7427,6009,844,1092,559,513,3008
7428,0,505,1930,1161,802,4398
7429,0,104,251,74,136,565
7430,0,2208,3199,1046,1625,8078
7431,0,17,26,23,8,74
7432,0,1187,2199,1299,524,5209
7433,0,680,1886,1678,601,4845
7434,3217,1093,1513,542,761,3909
7435,0,385,1881,846,797,3909
7436,0,2007,2931,838,1528,7304
7437,0,68,133,115,51,367
7438,0,217,295,231,106,849
7439,0,645,3602,1372,1532,7151
7440,0,844,1092,559,513,3008
7441,0,505,1930,1161,802,4398
7442,0,523,762,562,246,2093
7443,0,319,718,726,327,2090
7444,0,1087,1650,993,520,4250
7445,0,543,1567,1235,521,3866
7446,0,3216,5154,3482,1444,13296
7447,12787,1936,5068,4345,1627,12976
7448,0,2007,2931,838,1528,7304
7252,0,76,142,106,54,378
7449,0,3053,5445,3627,3191,15316
7450,0,2218,4366,3352,2523,12459
7451,7802,2007,2931,838,1528,7304
7452,0,645,3602,1372,1532,7151
7453,0,3819,8471,2570,4486,19346
7454,0,645,3602,1372,1532,7151
7455,0,0,0,0,0,0
7456,0,0,0,0,0,0
7457,0,79,300,98,153,630
7458,0,1381,2286,1062,1186,5915
7459,0,645,3602,1372,1532,7151
7460,0,2098,6704,3490,2900,15192
7461,0,348,1549,504,787,3188
7462,0,645,3602,1372,1532,7151
7463,0,5679,8236,6113,4326,24354
7464,0,0,0,0,0,0
7465,0,0,0,0,0,0
7466,0,4200,8688,6707,4516,24111
7467,0,3165,7099,2016,3850,16130
7468,0,207,409,415,198,1229
7469,0,287,431,354,165,1237
7470,0,2107,8648,3124,4084,17963
7471,0,645,3602,1372,1532,7151
7472,0,2007,2931,838,1528,7304
7473,0,2007,2931,838,1528,7304
7474,19219,2234,5930,3096,2711,13971
7475,0,1687,6932,2203,3367,14189
7476,0,419,1716,921,718,3774
7477,0,844,1092,559,513,3008
7478,0,505,1930,1161,802,4398
7479,0,1093,1513,542,761,3909
7480,0,385,1881,846,797,3909
7481,0,645,3602,1372,1532,7151
7482,7802,645,3602,1372,1532,7151
7483,0,2367,7952,3896,3535,17750
7484,0,523,762,562,246,2093
7486,0,319,718,726,327,2090
7487,0,207,409,415,198,1229
7488,0,1093,1513,542,761,3909
7489,0,194,1513,440,617,2764
7490,0,1187,2199,1299,524,5209
7491,0,680,1886,1678,601,4845
7492,0,570,1066,950,413,2999
7493,0,467,775,650,218,2110
7494,0,1694,4635,3872,1530,11731
7495,12787,3216,5154,3482,1444,13296
7496,0,186,306,228,142,862
7497,0,844,1092,559,513,3008
7498,0,505,1930,1161,802,4398
7499,0,3043,5416,3619,3182,15260
7500,0,2218,4366,3352,2523,12459
7501,0,844,1092,559,513,3008
7502,0,505,1930,1161,802,4398
7503,19219,2367,7952,3896,3535,17750
7504,0,0,0,0,0,0
7505,0,0,0,0,0,0
7506,0,505,1930,1161,802,4398
7507,0,844,1092,559,513,3008
7508,0,505,1930,1161,802,4398
7509,0,844,1092,559,513,3008
7510,0,844,1092,559,513,3008
7511,0,505,1930,1161,802,4398
7512,0,844,1092,559,513,3008
7513,0,505,1930,1161,802,4398
7514,0,2007,2931,838,1528,7304
7515,0,822,1123,197,615,2757
7516,0,194,1513,440,617,2764
7517,0,104,251,74,136,565
7518,0,3165,7099,2016,3850,16130
7519,0,645,3602,1372,1532,7151
7520,0,844,1092,559,513,3008
7521,0,1304,5374,2945,2297,11920
7522,0,793,1643,945,774,4155
7523,0,3271,7350,2090,3986,16697
7524,0,1717,6613,3400,2896,14626
7525,0,201,248,191,70,710
7526,0,114,307,295,135,851
7527,0,3271,7350,2090,3986,16697
7528,0,650,1339,496,637,3122
7529,0,201,248,191,70,710
7530,0,145,373,366,163,1047
7531,0,1687,6932,2203,3367,14189
7532,0,527,1547,750,734,3558
7533,0,31,66,71,28,196
7534,0,1687,6932,2203,3367,14189
7535,0,405,877,506,102,1890
7536,0,3043,5416,3619,3182,15260
7537,0,255,705,591,138,1689
7538,0,2352,4796,3724,2656,13528
7539,0,0,0,0,0,0
7540,0,0,0,0,0,0
7541,0,2036,8481,2707,4154,17378
7543,0,3271,7350,2090,3986,16697
7544,0,2935,4684,3061,1368,12048
7545,0,0,0,0,0,0
7546,0,0,0,0,0,0
7547,0,1694,4635,3872,1530,11731
7548,0,351,536,434,190,1511
7549,0,1187,2199,1299,524,5209
7550,0,329,1350,1244,412,3335
7551,0,358,929,582,161,2030
7552,0,255,705,591,138,1689
7553,0,2036,8481,2707,4154,17378
7554,0,5679,8236,6113,4326,24354
7555,0,8,25,26,139,198
7556,0,3339,5849,3942,3291,16421
7557,0,2352,4796,3724,2656,13528
7558,0,793,1643,945,774,4155
7353,0,681,1045,1026,673,3425
7559,0,628,833,919,510,2890
7560,16769,3671,7695,5729,4142,21237
7561,0,793,1643,945,774,4155
7562,0,558,1612,820,762,3752
7563,0,186,493,508,236,1423
7564,0,3339,5849,3942,3291,16421
7565,0,2242,4456,3327,2476,12501
7566,0,2007,2931,838,1528,7304
7567,0,558,1612,820,762,3752
7568,0,645,3602,1372,1532,7151
7569,0,3051,5490,3691,3186,15418
7570,0,2242,4456,3327,2476,12501
7571,0,0,0,0,0,0
7572,0,419,1716,921,718,3774
7573,0,851,1587,687,708,3833
7574,0,145,373,366,163,1047
7575,0,346,538,425,191,1500
7576,0,245,510,504,236,1495
7577,0,952,1654,777,310,3693
7578,0,329,1350,1244,412,3335
7579,0,3051,5490,3691,3186,15418
7580,0,2242,4456,3327,2476,12501
7581,0,622,1202,1078,459,3361
7582,0,1243,3739,3042,1219,9243
7583,0,851,1587,687,708,3833
7584,0,564,2090,1286,880,4820
7585,0,2935,4684,3061,1368,12048
7586,0,171,306,248,148,873
7587,0,844,1758,1339,599,4540
7588,0,523,762,562,246,2093
7589,0,319,718,726,327,2090
7590,0,1087,1650,993,520,4250
7591,0,543,1567,1235,521,3866
7592,0,851,1587,687,708,3833
7593,0,564,2090,1286,880,4820
7594,0,300,364,251,101,1016
7595,0,116,341,378,130,965
7596,0,1574,1030,554,754,3912
7597,16769,5060,7428,5220,3955,21663
7598,0,109,458,453,196,1216
7599,0,0,0,0,0,0
7600,0,1243,3739,3042,1219,9243
7601,0,1163,606,315,612,2696
7602,0,2617,7548,5867,3726,19758
7603,0,39,73,53,4,169
7604,0,358,929,582,161,2030
7605,0,290,786,641,166,1883
7606,0,2484,4107,2406,1133,10130
7607,0,0,0,0,0,0
7608,0,952,1654,777,310,3693
7609,0,329,1350,1244,412,3335
7610,0,3051,5490,3691,3186,15418
7611,10793,2242,4456,3327,2476,12501
7612,0,346,538,425,191,1500
7613,0,245,510,504,236,1495
7614,0,851,1587,687,708,3833
7615,0,564,2090,1286,880,4820
7616,0,300,364,251,101,1016
7617,0,116,341,378,130,965
7618,10793,3051,5490,3691,3186,15418
7619,0,2242,4456,3327,2476,12501
7620,0,3271,7350,2090,3986,16697
7621,0,843,1440,1163,523,3969
7622,0,844,1758,1339,599,4540
7623,0,0,0,0,0,0
7624,0,0,0,0,0,0
7625,0,822,1123,197,615,2757
7626,0,194,1513,440,617,2764
7627,0,3051,5490,3691,3186,15418
7628,0,2242,4456,3327,2476,12501
7629,0,397,1002,635,165,2199
7630,0,290,786,641,166,1883
7631,0,952,1654,777,310,3693
7632,0,329,1350,1244,412,3335
7633,0,843,1440,1163,523,3969
7634,0,844,1758,1339,599,4540
7635,0,2036,8481,2707,4154,17378
7636,0,5462,7194,4168,3333,20157
7637,0,0,0,0,0,0
7638,0,0,0,0,0,0
7639,0,1243,3739,3042,1219,9243
7640,0,0,0,0,0,0
7641,0,2617,7548,5867,3726,19758
7642,0,2484,4107,2406,1133,10130
7643,0,0,0,0,0,0
7644,0,2007,2931,838,1528,7304
7645,0,523,762,562,246,2093
7646,0,319,718,726,327,2090
7647,0,423,558,386,174,1541
7648,0,843,1440,1163,523,3969
7649,0,670,1664,1319,592,4245
7650,0,645,3602,1372,1532,7151
7651,0,3271,7350,2090,3986,16697
7652,0,3051,5490,3691,3186,15418
7653,0,2242,4456,3327,2476,12501
7654,0,300,364,251,101,1016
7655,0,116,341,378,130,965
7656,0,2036,8481,2707,4154,17378
7657,0,901,1320,993,459,3673
7658,0,670,1664,1319,592,4245
7785,0,260,702,589,140,1691
7659,0,397,1002,635,165,2199
7660,0,30,84,52,27,193
7661,0,161,238,47,131,577
7662,571,43,305,90,128,566
7663,0,952,1654,777,310,3693
7664,0,901,1320,993,459,3673
7665,0,813,2533,2342,765,6453
7667,0,793,1643,945,774,4155
7668,1195,212,583,476,260,1531
7669,0,2007,2931,838,1528,7304
7670,0,1,5,1,2,9
7671,0,558,1612,820,762,3752
7673,0,209,580,476,259,1524
7674,0,436,3027,898,1277,5638
7675,0,3051,5490,3691,3186,15418
7676,0,1666,2494,1547,530,6237
7677,0,2399,5775,4722,2887,15783
7678,0,851,1587,687,708,3833
7679,0,390,1654,794,694,3532
7680,3380,174,435,492,187,1288
7681,0,0,0,0,0,0
7682,0,0,0,0,0,0
7683,0,793,1643,945,774,4155
7684,0,649,1327,492,633,3101
7685,0,390,1654,794,694,3532
7686,0,5462,7194,4168,3333,20157
7687,0,0,0,0,0,0
7688,0,0,0,0,0,0
7689,0,2617,7548,5867,3726,19758
7690,0,558,1612,820,762,3752
7691,0,4062,6771,4293,3363,18489
7692,0,2399,5775,4722,2887,15783
7693,0,43,305,90,128,566
7694,571,161,238,47,131,577
7695,0,436,3027,898,1277,5638
7696,0,0,0,0,0,0
7697,0,2399,5775,4722,2887,15783
7698,0,523,762,562,246,2093
7699,0,319,718,726,327,2090
7700,0,4062,6771,4293,3363,18489
7701,0,0,0,0,0,0
7702,0,0,0,0,0,0
7703,0,1243,3739,3042,1219,9243
7704,0,2484,4107,2406,1133,10130
7705,0,0,0,0,0,0
7707,0,793,1643,945,774,4155
7708,0,558,1612,820,762,3752
7710,0,188,396,352,162,1098
7711,0,583,893,736,306,2518
7712,0,1087,1650,993,520,4250
7713,0,570,1694,1361,605,4230
7714,0,649,1327,492,633,3101
7715,0,390,1654,794,694,3532
7716,0,300,364,251,101,1016
7717,0,116,341,378,130,965
7718,0,0,0,0,0,0
7719,11005,2399,5776,4723,2887,15785
7720,0,822,1123,197,615,2757
7721,0,194,1513,440,617,2764
7722,0,1611,2386,472,1309,5778
7723,0,0,0,0,0,0
7724,0,4062,6771,4293,3363,18489
7725,0,0,1,1,0,2
7726,0,0,144,1,0,145
7727,0,0,0,0,0,0
7728,0,436,3027,898,1277,5638
7729,0,5462,7194,4168,3333,20157
7730,0,471,721,478,117,1787
7731,0,0,1,1,0,2
7732,0,0,144,1,0,145
7733,0,793,1643,945,774,4155
7734,0,0,0,0,0,0
7735,0,471,721,478,117,1787
7736,0,2777,8451,6419,3851,21498
7737,0,0,0,0,0,0
7738,0,1243,3739,3042,1219,9243
7739,0,2484,4107,2406,1133,10130
7740,0,0,0,0,0,0
7741,0,558,1612,820,762,3752
7742,0,1243,3739,3042,1219,9243
7743,0,2484,4107,2406,1133,10130
7744,0,0,0,0,0,0
7745,0,0,0,0,0,0
7746,0,1220,1738,1069,585,4612
7747,0,570,1694,1361,605,4230
7748,0,649,1327,492,633,3101
7749,0,390,1654,794,694,3532
7750,0,523,762,562,246,2093
7751,0,319,718,726,327,2090
7752,0,822,1123,197,615,2757
7753,0,194,1513,440,617,2764
7754,0,0,1,1,0,2
7755,0,0,144,1,0,145
7756,0,649,1327,492,633,3101
7757,0,390,1654,794,694,3532
7758,11005,4062,6915,4293,3363,18633
7759,0,2399,5776,4723,2887,15785
7760,0,0,1,1,0,2
7761,0,0,144,1,0,145
7762,0,160,904,552,126,1742
7763,0,471,721,478,117,1787
7764,0,1220,1738,1069,585,4612
7765,0,570,1694,1361,605,4230
7766,0,37,75,46,0,158
7767,0,160,515,256,126,1057
7768,0,180,289,207,117,793
7769,0,822,1123,197,615,2757
7770,0,194,1513,440,617,2764
7771,0,0,1,1,0,2
7772,0,0,144,1,0,145
7773,0,346,538,425,191,1500
7774,0,245,510,504,236,1495
7775,0,5933,7915,4646,3450,21944
7776,20048,2777,8451,6419,3851,21498
7777,0,649,1327,492,633,3101
7778,0,390,1654,794,694,3532
7779,0,793,1643,945,774,4155
7780,0,4062,6915,4293,3363,18633
7781,0,2399,5776,4723,2887,15785
7782,0,1243,3739,3042,1219,9243
7783,0,2484,4107,2406,1133,10130
7784,0,558,1612,820,762,3752
7786,0,160,904,552,126,1742
7787,0,471,721,478,117,1787
7788,3380,202,260,195,75,732
7789,0,174,435,492,187,1288
7790,0,40,60,40,23,163
7791,0,0,1,1,0,2
7792,0,24,210,50,24,308
7793,0,1220,1738,1069,585,4612
7794,0,570,1694,1361,605,4230
7795,0,0,0,0,0,0
7796,0,0,0,0,0,0
7797,0,822,1123,197,615,2757
7798,2761,194,1513,440,617,2764
7799,0,4062,6915,4293,3363,18633
7800,0,2399,5776,4723,2887,15785
7801,0,217,364,253,117,951
7802,0,160,515,256,126,1057
7803,0,346,538,425,191,1500
7804,0,245,510,504,236,1495
7805,0,40,61,41,23,165
7806,0,130,431,204,99,864
7807,0,140,229,166,94,629
7808,0,180,289,207,117,793
7809,0,130,431,204,99,864
7810,0,2484,4107,2406,1133,10130
7811,0,0,0,0,0,0
7812,0,1611,2386,472,1309,5778
7813,0,40,50,7,25,122
7814,0,0,0,0,0,0
7815,0,1243,3739,3042,1219,9243
7816,0,0,0,0,0,0
7817,0,40,50,7,25,122
7818,0,442,3107,916,1301,5766
7819,0,1220,1738,1069,585,4612
7820,0,570,1694,1361,605,4230
7821,0,217,364,253,117,951
7822,0,160,515,256,126,1057
7823,0,7,80,18,25,130
7824,0,40,50,7,25,122
7825,20048,5933,7915,4646,3450,21944
7826,0,217,364,253,117,951
7827,0,160,515,256,126,1057
7828,0,0,0,0,0,0
7829,0,202,422,390,171,1185
7830,0,4062,6915,4293,3363,18633
7831,0,2248,5458,4402,2756,14864
7832,0,217,364,253,117,951
7833,0,160,515,256,126,1057
7834,0,2777,8451,6419,3851,21498
7835,0,7,80,18,25,130
7836,0,40,50,7,25,122
7837,0,7,80,18,25,130
7838,0,40,50,7,25,122
7839,0,40,50,7,25,122
7840,0,7,80,18,25,130
7841,0,7,80,18,25,130
7842,0,40,50,7,25,122
7785,0,255,356,225,0,836
7843,0,160,904,552,126,1742
7844,0,217,364,253,117,951
7845,0,7,80,18,25,130
7846,0,40,50,7,25,122
7847,0,793,1643,945,774,4155
7848,0,105,221,155,75,556
7849,0,140,229,166,94,629
7850,0,1651,2436,478,1333,5898
7851,0,180,289,207,117,793
7852,0,130,431,204,99,864
7853,0,300,364,251,101,1016
7854,0,116,341,378,130,965
7855,0,558,1612,820,762,3752
7856,0,442,3107,916,1301,5766
7857,0,180,289,207,117,793
7858,0,130,431,204,99,864
7859,0,1220,1738,1069,585,4612
7860,0,570,1694,1361,605,4230
7861,0,0,0,0,0,0
7862,909,0,0,0,0,0
7863,0,5933,7915,4646,3450,21944
7864,0,2777,8451,6419,3851,21498
7865,0,7,80,18,25,130
7866,0,40,50,7,25,122
7867,0,130,431,204,99,864
7868,0,180,289,207,117,793
7869,0,793,1643,945,774,4155
7870,0,558,1612,820,762,3752
7871,0,427,753,632,277,2089
7872,0,2484,4107,2406,1133,10130
7873,0,37,118,86,48,289
7874,0,353,644,564,238,1799
7875,0,926,3212,2564,1029,7731
7876,0,105,221,155,75,556
7877,0,140,229,166,94,629
7878,0,523,762,562,246,2093
7879,0,319,718,726,327,2090
7880,0,5933,7915,4646,3450,21944
7881,0,793,1643,945,774,4155
7882,0,558,1612,820,762,3752
7883,0,2777,8451,6419,3851,21498
7884,0,0,0,0,0,0
7885,0,202,260,195,75,732
7886,0,174,435,492,187,1288
7887,0,1220,1738,1069,585,4612
7888,0,570,1694,1361,605,4230
7889,0,105,221,155,75,556
7890,0,140,229,166,94,629
7891,0,3853,6581,4019,3257,17710
7892,0,817,1908,2017,824,5566
7893,0,1604,3888,2654,2058,10204
7894,0,300,364,251,101,1016
7895,0,116,341,378,130,965
7896,0,180,289,207,117,793
7897,0,130,431,204,99,864
7898,0,5933,7915,4646,3450,21944
7899,0,822,1123,197,615,2757
7900,0,194,1513,440,617,2764
7901,0,2777,8451,6419,3851,21498
7902,0,0,0,0,0,0
7903,0,0,0,0,0,0
7904,0,523,762,562,246,2093
7905,0,319,718,726,327,2090
7906,0,5933,7915,4646,3450,21944
7907,0,2202,3554,1916,945,8617
7908,0,0,0,0,0,0
7909,0,0,0,0,0,0
7910,11877,926,3212,2564,1029,7731
7911,0,194,1513,440,617,2764
7912,0,822,1123,197,615,2757
7913,0,7,80,18,25,130
7914,0,40,50,7,25,122
7915,2761,822,1123,197,615,2757
7916,0,194,1513,440,617,2764
7917,0,2777,8451,6419,3851,21498
7918,0,793,1643,945,774,4155
7919,0,1651,2436,478,1333,5898
7920,0,346,538,425,191,1500
7921,0,245,510,504,236,1495
7922,0,442,3107,916,1301,5766
7923,0,875,1687,960,782,4304
7924,909,0,0,0,0,0
7925,0,0,0,0,0,0
7926,0,875,1687,960,782,4304
7927,0,36,45,7,25,113
7928,0,7,80,18,25,130
7929,0,4,5,0,0,9
7930,0,822,1123,197,615,2757
7931,0,194,1513,440,617,2764
7932,0,558,1612,820,762,3752
7933,0,875,1687,960,782,4304
7934,0,649,1327,492,633,3101
7935,0,390,1654,794,694,3532
7936,0,300,364,251,101,1016
7937,0,875,1687,960,782,4304
7938,0,116,341,378,130,965
7939,9421,1176,2051,1211,883,5321
7940,0,1176,2051,1211,883,5321
7941,0,1176,2051,1211,883,5321
7942,0,1176,2051,1211,883,5321
7938,0,95,204,188,81,568
7943,0,0,0,0,0,0
7944,0,875,1687,960,782,4304
7945,0,793,1643,945,774,4155
7946,0,592,1710,970,823,4095
7947,0,592,1710,970,823,4095
7948,0,592,1710,970,823,4095
7949,0,0,0,0,0,0
7950,9421,708,2052,1347,953,5060
7951,0,708,2052,1347,953,5060
7952,0,1109,1488,1156,471,4224
7953,0,817,1908,2017,824,5566
7954,0,708,2052,1347,953,5060
7955,0,558,1612,820,762,3752
7956,0,0,0,0,0,0
7957,0,592,1710,970,823,4095
7949,0,478,612,454,190,1734
7958,0,558,1612,820,762,3752
7959,0,321,787,818,322,2248
7960,0,0,0,0,0,0
7961,0,0,0,0,0,0
7962,0,0,0,0,0,0
7963,0,0,0,0,0,0
7964,0,5933,7915,4646,3450,21944
7965,0,875,1687,960,782,4304
7966,0,0,0,0,0,0
7967,0,0,0,0,0,0
7968,0,34,68,52,22,176
7969,0,33,79,50,23,185
7970,0,2917,5431,3133,2913,14394
7971,9473,1604,3888,2654,2058,10204
7972,0,592,1710,970,823,4095
7973,0,2777,8451,6419,3851,21498
7974,0,202,260,195,75,732
7975,0,174,435,492,187,1288
7978,0,0,18,0,0,18
7979,0,4,5,0,0,9
7980,0,875,1687,960,782,4304
7983,0,5933,7915,4646,3450,21944
7989,0,592,1710,970,823,4095
7990,0,202,260,195,75,732
7991,0,174,435,492,187,1288
7992,0,2777,8451,6419,3851,21498
7993,0,875,1687,960,782,4304
7994,0,875,1687,960,782,4304
7997,0,1220,1738,1069,585,4612
7998,0,570,1694,1361,605,4230
7999,0,875,1687,960,782,4304
8000,0,1651,2436,478,1333,5898
8001,11877,2202,3554,1916,945,8617
8002,0,0,0,0,0,0
8003,0,592,1710,970,823,4095
8004,0,0,0,0,0,0
8005,0,926,3212,2564,1029,7731
8006,0,592,1710,970,823,4095
8007,0,442,3107,916,1301,5766
8008,0,875,1687,960,782,4304
8011,0,592,1710,970,823,4095
8012,0,2202,3554,1916,945,8617
8013,0,649,1327,492,633,3101
8014,0,33,79,50,23,185
8015,0,424,1723,847,716,3710
8016,0,140,401,330,166,1037
8017,0,786,2812,2234,864,6696
8018,0,1220,1738,1069,585,4612
8019,0,19,45,42,18,124
8020,0,1399,3290,2242,1355,8286
8023,0,1651,2436,478,1333,5898
8024,0,592,1710,970,823,4095
8025,0,1193,1692,1031,571,4487
8026,0,2202,3554,1916,945,8617
8027,0,734,1374,1076,820,4004
8028,0,1840,3006,1570,763,7179
8029,0,1040,1408,1352,931,4731
8030,0,734,1374,1076,820,4004
8031,0,0,0,0,0,0
8032,0,0,0,0,0,0
8033,0,105,221,155,75,556
8034,0,140,229,166,94,629
8035,0,442,3107,916,1301,5766
8036,0,5933,7915,4646,3450,21944
8037,0,1399,3290,2242,1355,8286
8038,0,1097,1922,1422,1001,5442
8039,0,2777,8451,6419,3851,21498
8040,0,1040,1408,1352,931,4731
8043,0,822,1123,197,615,2757
8044,0,194,1513,440,617,2764
8045,0,1766,3357,1960,1376,8459
8046,0,1399,3290,2242,1355,8286
8047,0,2740,4013,2593,1529,10875
8048,0,1520,4185,3310,1684,10699
8051,0,34,68,52,22,176
8052,0,33,79,50,23,185
8053,0,682,1405,543,655,3285
8054,0,424,1723,847,716,3710
8055,0,202,260,195,75,732
8056,0,34,68,52,22,176
8057,0,207,514,542,209,1472
8058,0,1766,3357,1960,1376,8459
8059,0,1651,2436,478,1333,5898
8060,0,0,0,0,0,0
8061,0,442,3107,916,1301,5766
8062,0,0,18,0,0,18
8063,0,4,5,0,0,9
8064,0,682,1405,543,655,3285
8065,0,424,1723,847,716,3710
8068,0,194,1513,440,617,2764
8069,0,822,1123,197,615,2757
8070,0,245,510,504,236,1495
8071,0,346,538,425,191,1500
8072,109,0,0,0,0,0
8073,0,33,79,50,23,185
8074,0,34,68,52,22,176
8075,0,0,0,0,0,0
8076,0,0,0,0,0,0
8077,0,442,3107,916,1301,5766
8078,0,1399,3290,2242,1355,8286
8079,0,2740,4013,2593,1529,10875
8080,0,1520,4185,3310,1684,10699
8081,0,1097,1922,1422,1001,5442
8082,0,0,0,0,0,0
8083,0,1651,2436,478,1333,5898
8084,0,1651,2436,478,1333,5898
8087,0,236,329,247,97,909
8088,0,207,514,542,209,1472
8089,0,0,0,0,0,0
8090,0,1040,1408,1352,931,4731
8091,0,1766,3357,1960,1376,8459
8092,0,1651,2436,478,1333,5898
8095,0,33,79,50,23,185
8096,0,34,68,52,22,176
8097,0,0,0,0,0,0
8098,0,1604,3888,2654,2058,10204
8099,0,1399,3290,2242,1355,8286
8100,0,1651,2436,478,1333,5898
8101,9473,2917,5431,3133,2913,14394
8102,0,0,0,0,0,0
8105,0,0,0,0,0,0
8106,0,0,0,0,0,0
8107,0,1109,1488,1156,471,4224
8108,0,105,221,155,75,556
8109,0,956,2136,2183,918,6193
8112,0,0,0,0,0,0
8113,5832,442,3107,916,1301,5766
8116,0,554,756,557,241,2108
8117,0,321,787,818,322,2248
8120,0,5933,7915,4646,3450,21944
8121,0,1766,3357,1960,1376,8459
8122,0,236,329,247,97,909
8123,0,207,514,542,209,1472
8124,0,442,3107,916,1301,5766
8125,0,442,3107,916,1301,5766
8126,0,1399,3290,2242,1355,8286
8127,0,2777,8451,6419,3851,21498
8128,5832,1651,2436,478,1333,5898
8129,0,1214,1709,1310,545,4778
8130,0,956,2136,2183,918,6193
8131,0,1097,1922,1422,1001,5442
8132,0,2917,5431,3133,2913,14394
8133,0,885,2533,1589,1244,6251
8134,0,0,0,0,0,0
8135,0,0,0,0,0,0
8136,0,1766,3357,1960,1376,8459
8137,0,914,1009,1028,776,3727
8138,0,1012,2932,1913,1400,7257
8139,0,442,3107,916,1301,5766
8140,0,2740,4013,2593,1529,10875
8141,0,1520,4185,3310,1684,10699
8142,0,3295,5997,3489,3100,15881
8143,0,554,756,557,241,2108
8144,0,321,787,818,322,2248
8147,0,5933,7915,4646,3450,21944
8148,0,0,0,0,0,0
8149,0,33,79,50,23,185
8150,0,34,68,52,22,176
8151,0,0,0,0,0,0
8152,0,2777,8451,6419,3851,21498
8153,0,1651,2436,478,1333,5898
8154,0,1214,1709,1310,545,4778
8155,0,956,2136,2183,918,6193
8156,0,442,3107,916,1301,5766
8157,0,236,329,247,97,909
8158,0,207,514,542,209,1472
8159,0,682,1405,543,655,3285
8160,0,424,1723,847,716,3710
8161,0,1651,2436,478,1333,5898
8162,0,0,0,0,0,0
8163,0,845,1357,1157,502,3861
8164,0,2740,4013,2593,1529,10875
8165,5924,804,3086,2287,1301,7478
8166,0,1214,1709,1310,545,4778
8167,0,956,2136,2183,918,6193
8168,0,2381,4988,2461,2324,12154
8169,0,1012,2932,1913,1400,7257
8170,0,666,1759,1848,755,5028
8171,0,5933,7915,4646,3450,21944
8172,0,282,512,318,166,1278
8175,0,0,0,0,0,0
8176,0,0,0,0,0,0
8178,0,1399,3290,2242,1355,8286
8179,0,0,0,0,0,0
8180,0,442,3107,916,1301,5766
8181,0,450,1266,1399,559,3674
8182,0,2609,7697,5339,3458,19103
8183,0,0,0,0,0,0
8184,0,1766,3357,1960,1376,8459
8185,0,0,0,0,0,0
8186,0,0,0,0,0,0
8187,0,682,1405,543,655,3285
8188,832,424,1723,847,716,3710
8189,0,33,79,50,23,185
8190,0,34,68,52,22,176
8191,0,0,18,0,0,18
8192,0,4,5,0,0,9
8193,0,260,597,593,247,1697
8194,0,554,756,557,241,2108
8195,0,62,191,226,76,555
8196,0,1214,1709,1310,545,4778
8197,0,956,2136,2183,918,6193
8198,0,140,148,96,40,424
8199,0,62,191,226,76,555
8200,0,1651,2436,478,1333,5898
8201,0,0,18,0,0,18
8202,0,4,5,0,0,9
8203,0,442,3107,916,1301,5766
8204,0,1651,2436,478,1333,5898
8205,0,0,0,0,0,0
8206,0,0,0,0,0,0
8207,0,442,3107,916,1301,5766
8208,0,1651,2436,478,1333,5898
8209,0,0,0,0,0,0
8210,0,0,0,0,0,0
8211,0,442,3107,916,1301,5766
8212,0,1651,2436,478,1333,5898
8213,0,0,0,0,0,0
8214,0,0,0,0,0,0
8215,0,442,3107,916,1301,5766
8216,0,1651,2436,478,1333,5898
7927,0,207,497,542,209,1455
8217,0,236,329,247,97,909
8218,0,0,18,0,0,18
8219,0,442,3107,916,1301,5766
8220,0,5072,7079,4154,3239,19544
8221,0,204,375,271,109,959
8222,0,1651,2436,478,1333,5898
8223,0,0,0,0,0,0
8224,0,0,0,0,0,0
8225,0,1651,2436,478,1333,5898
8226,0,140,148,96,40,424
8227,990,62,191,226,76,555
8228,0,570,1069,903,367,2909
8229,0,408,727,604,261,2000
8230,17917,2380,7368,4982,3336,18066
8231,0,1651,2436,478,1333,5898
8232,0,34,68,52,22,176
8233,0,33,79,50,23,185
8234,0,442,3107,916,1301,5766
8235,0,0,0,0,0,0
8236,0,0,0,0,0,0
8237,0,100,94,52,24,270
8238,0,37,141,170,53,401
8239,0,442,3107,916,1301,5766
8240,0,1651,2436,478,1333,5898
8241,0,66,105,71,35,277
8242,832,682,1405,543,655,3285
8243,0,431,1775,881,741,3828
8244,0,442,3107,916,1301,5766
8245,0,442,3107,916,1301,5766
8246,0,37,141,170,53,401
8247,0,100,94,52,24,270
8248,0,442,3107,916,1301,5766
8249,0,1651,2436,478,1333,5898
8250,0,318,809,848,351,2326
8251,0,1214,1709,1310,545,4778
8252,0,666,1369,1370,581,3986
8253,0,0,0,0,0,0
8254,0,0,0,0,0,0
8255,0,0,0,0,0,0
8256,0,1399,3290,2242,1355,8286
8257,0,1766,3357,1960,1376,8459
8258,0,0,0,0,0,0
8261,0,0,18,0,0,18
8262,0,4,5,0,0,9
8263,0,1651,2436,478,1333,5898
8264,0,1651,2436,478,1333,5898
8265,0,3271,7350,2090,3986,16697
8266,0,442,3107,916,1301,5766
8267,0,4,5,0,0,9
8268,0,0,18,0,0,18
8269,0,442,3107,916,1301,5766
8270,0,31,62,64,27,184
8271,990,140,148,96,40,424
8272,0,37,141,170,53,401
8273,17403,2036,8481,2707,4154,17378
8274,0,2381,4988,2461,2324,12154
8275,0,12,13,9,5,39
8276,0,211,421,413,178,1223
8277,0,300,415,357,153,1225
8278,0,815,2531,1513,1229,6088
8279,109,0,0,0,0,0
8280,0,0,0,0,0,0
8281,0,615,903,752,299,2569
8282,0,666,1369,1370,581,3986
8283,0,4,5,0,0,9
8284,0,0,18,0,0,18
8287,17917,4869,6727,3822,3087,18505
8288,0,0,0,0,0,0
8289,0,0,0,0,0,0
8290,0,1399,3290,2242,1355,8286
8291,0,0,18,0,0,18
8292,0,4,5,0,0,9
8293,17917,2380,7368,4982,3336,18066
8294,0,1399,3290,2242,1355,8286
8295,0,150,288,269,104,811
8296,5924,2146,2866,1504,1133,7649
8297,0,709,2916,2077,1246,6948
8298,0,1766,3357,1960,1376,8459
8299,0,1399,3290,2242,1355,8286
8300,0,1399,3290,2242,1355,8286
8301,0,1766,3357,1960,1376,8459
8302,0,4,5,0,0,9
8303,0,0,18,0,0,18
8304,0,1766,3357,1960,1376,8459
8305,0,1766,3357,1960,1376,8459
8306,0,4,5,0,0,9
8307,0,0,18,0,0,18
8308,0,4,5,0,0,9
8309,0,0,18,0,0,18
8310,0,0,0,0,0,0
8311,0,1399,3290,2242,1355,8286
8312,0,97,289,112,140,638
8313,0,76,250,102,120,548
8316,0,0,0,0,0,0
8317,0,0,0,0,0,0
8318,0,720,1443,564,670,3397
8319,0,431,1775,881,741,3828
8320,0,615,903,752,299,2569
8321,0,666,1369,1370,581,3986
8322,0,1766,3357,1960,1376,8459
8323,0,0,0,0,0,0
8324,0,1399,3290,2242,1355,8286
8325,0,1766,3357,1960,1376,8459
8326,0,0,0,0,0,0
8327,0,0,0,0,0,0
8328,0,0,0,0,0,0
8329,0,0,0,0,0,0
8330,0,1766,3357,1960,1376,8459
8331,0,0,18,0,0,18
8332,0,4,5,0,0,9
8333,0,4,5,0,0,9
8334,0,0,18,0,0,18
8335,0,319,718,726,327,2090
8336,0,523,762,562,246,2093
8337,0,2094,4587,2114,2175,10970
8338,0,0,0,0,0,0
8339,0,720,1443,564,670,3397
8340,0,431,1775,881,741,3828
8341,0,0,0,0,0,0
8342,12092,815,2531,1513,1229,6088
8343,0,0,0,0,0,0
8344,0,0,0,0,0,0
8345,0,97,289,112,140,638
8346,0,76,250,102,120,548
8347,0,0,0,0,0,0
8348,0,1399,3290,2242,1355,8286
8349,0,0,0,0,0,0
8350,0,0,0,0,0,0
8351,0,0,18,0,0,18
8352,0,4,5,0,0,9
8353,0,1766,3357,1960,1376,8459
8354,0,0,0,0,0,0
8355,0,615,903,752,299,2569
8356,0,666,1369,1370,581,3986
8357,17917,4869,6727,3822,3087,18505
8359,0,0,0,0,0,0
8360,0,97,289,112,140,638
8361,0,76,250,102,120,548
8362,0,0,0,0,0,0
8363,0,2380,7368,4982,3336,18066
8364,0,19,27,11,9,66
8365,0,11,64,31,20,126
8366,0,0,0,0,0,0
8367,0,0,0,0,0,0
8368,0,2041,2667,1344,1082,7134
8369,0,709,2916,2077,1246,6948
8370,6222,1399,3290,2242,1355,8286
8371,0,615,903,752,299,2569
8372,0,666,1369,1370,581,3986
8373,0,0,18,0,0,18
8374,0,4,5,0,0,9
8375,0,97,289,112,140,638
8376,0,76,250,102,120,548
8377,0,615,903,752,299,2569
8378,0,666,1369,1370,581,3986
8379,0,2041,2667,1344,1082,7134
8380,0,709,2916,2077,1246,6948
8381,0,666,1369,1370,581,3986
8382,0,615,903,752,299,2569
8383,0,615,903,752,299,2569
8384,0,666,1369,1370,581,3986
8385,0,861,1579,1390,544,4374
8386,0,257,489,373,157,1276
8387,0,1779,3939,2737,1649,10104
8388,0,720,1443,564,670,3397
8389,0,431,1775,881,741,3828
8390,0,0,18,0,0,18
8391,0,4,5,0,0,9
8392,0,100,94,52,24,270
8393,0,37,141,170,53,401
8394,0,1766,3357,1960,1376,8459
8395,0,0,0,0,0,0
8396,0,815,2531,1513,1229,6088
8397,12092,2094,4587,2114,2175,10970
8398,0,0,0,0,0,0
8399,0,632,1102,958,398,3090
8400,0,1766,3357,1960,1376,8459
8401,6222,1766,3357,1960,1376,8459
8402,0,0,0,0,0,0
8403,0,1779,3939,2737,1649,10104
8404,0,0,18,0,0,18
8405,0,4,5,0,0,9
8406,0,2140,3970,2545,1617,10272
8407,0,0,0,0,0,0
8408,0,97,289,112,140,638
8409,0,76,250,102,120,548
8410,0,0,18,0,0,18
8411,0,4,5,0,0,9
8412,0,2094,4587,2114,2175,10970
8413,0,815,2531,1513,1229,6088
8414,0,97,289,112,140,638
8415,0,76,250,102,120,548
8416,0,2041,2667,1344,1082,7134
8417,0,709,2916,2077,1246,6948
8418,0,2094,4587,2114,2175,10970
8419,0,1779,3939,2737,1649,10104
8420,0,0,18,0,0,18
8421,0,4,5,0,0,9
8422,0,2041,2667,1344,1082,7134
8423,0,709,2916,2077,1246,6948
8424,0,97,289,112,140,638
8425,0,76,250,102,120,548
8426,0,2140,3970,2545,1617,10272
8427,0,97,289,112,140,638
8428,0,76,250,102,120,548
8429,0,11,64,31,20,126
8430,0,19,27,11,9,66
8431,0,97,289,112,140,638
8432,0,76,250,102,120,548
8433,0,2094,4587,2114,2175,10970
8434,0,2,4,2,1,9
8435,0,1461,2601,1860,1158,7080
8436,0,319,1338,877,491,3025
8437,0,523,982,425,327,2257
8438,0,815,2541,1517,1229,6102
8439,0,2,4,2,1,9
8440,0,4,5,0,0,9
8441,0,0,18,0,0,18
8442,0,0,0,0,0,0
8443,0,2140,3970,2545,1617,10272
8444,0,4869,6727,3822,3087,18505
8445,0,4,5,0,0,9
8446,0,0,18,0,0,18
8447,0,0,0,0,0,0
8448,0,2380,7368,4982,3336,18066
8449,0,11,64,31,20,126
8450,0,19,27,11,9,66
8451,0,100,94,52,24,270
8452,0,37,141,170,53,401
8453,0,3408,4125,1961,1930,11424
8454,0,327,1351,889,495,3062
8455,0,1240,2664,1915,1186,7005
8456,0,3416,4139,1973,1934,11462
8457,0,1240,2664,1915,1186,7005
8458,0,1467,6056,3955,2646,14124
8459,0,2041,2667,1344,1082,7134
8460,0,709,2916,2077,1246,6948
8461,0,2041,2667,1344,1082,7134
8462,0,709,2916,2077,1246,6948
8463,0,720,1443,564,670,3397
8464,0,100,94,52,24,270
8465,0,468,1915,1049,794,4226
8466,0,815,2541,1517,1229,6102
8467,0,901,1307,630,431,3269
8468,0,3416,4139,1973,1934,11462
8469,0,1467,6056,3955,2646,14124
8470,0,229,612,663,266,1770
8471,0,2041,2667,1344,1082,7134
8472,0,533,2426,1468,1031,5458
8473,0,4317,5446,2603,2366,14732
8474,0,1467,6056,3955,2646,14124
8475,0,523,991,429,327,2270
8476,0,2,4,2,1,9
8477,0,818,1535,614,693,3660
8478,0,468,1915,1049,794,4226
8479,0,1572,3608,1691,1850,8721
8480,0,0,0,0,0,0
8481,0,0,0,0,0,0
8482,0,815,2541,1517,1229,6102
8483,0,4317,5446,2603,2366,14732
8484,0,1467,6056,3955,2646,14124
8485,0,4317,5446,2603,2366,14732
8486,0,1467,6056,3955,2646,14124
8487,0,818,1535,614,693,3660
8488,0,468,1915,1049,794,4226
8489,0,19,27,11,9,66
8490,0,11,64,31,20,126
8491,0,1572,3608,1691,1850,8721
8492,0,815,2541,1517,1229,6102
8493,0,1594,2151,958,940,5643
8494,0,533,2426,1468,1031,5458
8495,0,4317,5446,2603,2366,14732
8496,0,1467,6056,3955,2646,14124
8497,0,1572,3608,1691,1850,8721
8498,0,40,69,45,24,178
8499,0,416,1005,1034,430,2885
8500,0,176,0,360,0,536
8501,0,454,1660,554,842,3510
8502,0,19,27,11,9,66
8503,0,11,64,31,20,126
8504,0,1594,2151,958,940,5643
8505,0,533,2426,1468,1031,5458
8506,0,73,89,33,52,247
8507,0,523,991,429,327,2270
8508,0,24,116,52,45,237
8509,0,522,922,890,384,2718
8510,0,615,903,752,299,2569
8511,0,199,585,556,250,1590
8512,0,73,98,37,52,260
8513,0,24,116,52,45,237
8514,0,73,98,37,52,260
8515,0,24,116,52,45,237
8516,0,1436,3678,1376,1873,8363
8517,0,454,1660,554,842,3510
8518,0,73,98,37,52,260
8519,0,24,116,52,45,237
8520,0,73,98,37,52,260
8521,0,24,116,52,45,237
8522,0,1436,3678,1376,1873,8363
8523,0,4317,5446,2603,2366,14732
8524,0,454,1660,554,842,3510
8525,0,1467,6056,3955,2646,14124
8526,0,0,0,0,0,0
8527,0,4317,5446,2603,2366,14732
8528,0,73,98,37,52,260
8529,0,24,116,52,45,237
8530,0,172,397,432,175,1176
8531,0,1616,6107,3861,2617,14201
8532,0,321,448,338,147,1254
8533,0,172,397,432,175,1176
8534,0,73,98,37,52,260
8535,0,24,116,52,45,237
8536,0,1616,6107,3861,2617,14201
8537,0,4317,5446,2603,2366,14732
8538,0,321,448,338,147,1254
8539,0,172,397,432,175,1176
8540,0,451,881,866,382,2580
8541,0,4317,5446,2603,2366,14732
0,0,33,144,90,61,328
8542,0,1594,2151,958,940,5643
8543,0,73,98,37,52,260
8544,0,534,2514,1498,1057,5603
0,0,666,1154,1113,459,3392
8545,0,983,5097,2837,2218,11135
8546,0,1436,3678,1376,1873,8363
8547,0,0,0,0,0,0
8548,0,19,27,11,9,66
8549,0,11,64,31,20,126
8550,0,0,0,0,0,0
8551,10955,454,1660,554,842,3510
8552,0,19,27,11,9,66
8553,0,11,64,31,20,126
8554,0,48,64,35,23,170
8555,0,199,585,556,250,1590
8556,0,97,289,112,140,638
8557,0,76,250,102,120,548
8558,0,97,289,112,140,638
8559,0,76,250,102,120,548
8560,0,3538,4396,1705,2020,11659
8561,0,983,5097,2837,2218,11135
8562,0,97,289,112,140,638
8563,0,76,250,102,120,548
8564,0,48,64,35,23,170
8565,0,199,585,556,250,1590
8566,0,1644,2222,972,973,5811
8567,0,534,2514,1498,1057,5603
8568,0,321,448,338,147,1254
8569,0,172,397,432,175,1176
8570,0,1644,2222,972,973,5811
8571,0,534,2514,1498,1057,5603
8572,10955,1436,3678,1376,1873,8363
8573,0,0,0,0,0,0
8574,0,0,0,0,0,0
8575,0,454,1660,554,842,3510
8576,0,1644,2222,972,973,5811
8577,0,534,2514,1498,1057,5603
8578,0,1436,3678,1376,1873,8363
8579,0,440,1610,528,829,3407
8580,0,14,50,27,13,104
8581,0,97,289,112,140,638
8582,0,76,250,102,120,548
8583,0,97,289,112,140,638
8584,0,76,250,102,120,548
8585,0,177,484,497,215,1373
8586,0,48,64,35,23,170
8587,0,366,576,381,180,1503
8588,0,1644,2222,972,973,5811
8589,0,534,2514,1498,1057,5603
8590,0,1436,3678,1376,1873,8363
8591,0,16,73,32,28,149
8592,0,3538,4396,1705,2020,11659
8593,0,0,0,0,0,0
8594,0,457,1682,559,856,3554
8595,0,983,5097,2837,2218,11135
8596,0,77,242,91,120,530
8597,0,14,50,27,13,104
8598,0,533,1924,650,976,4083
8599,0,321,448,338,147,1254
8600,0,172,397,432,175,1176
8601,0,77,242,91,120,530
8602,0,14,50,27,13,104
8603,0,24,32,9,17,82
8604,0,366,576,381,180,1503
8605,0,97,289,112,140,638
8606,0,69,230,86,115,500
8607,0,10,47,30,11,98
8608,0,3538,4396,1705,2020,11659
8609,0,983,5097,2837,2218,11135
8610,0,7,12,5,3,27
8611,0,87,266,98,133,584
8612,0,10,47,30,11,98
8613,0,194,426,442,190,1252
8614,0,321,448,338,147,1254
8615,0,0,0,0,0,0
8616,0,93,278,103,136,610
8617,0,4,28,13,6,51
8618,0,7,20,17,5,49
8619,0,11,64,31,20,126
8620,0,93,278,103,136,610
8621,0,12,16,6,6,40
8622,0,24,32,9,17,82
8623,0,366,576,381,180,1503
8624,0,818,1535,614,693,3660
8625,0,468,1915,1049,794,4226
8626,0,19,27,11,9,66
8627,0,11,64,31,20,126
8628,0,94,303,115,147,659
8629,0,19,35,23,11,88
8630,0,533,1924,650,976,4083
8631,0,1453,3750,1408,1901,8512
8632,0,24,32,9,17,82
8633,0,366,576,381,180,1503
8634,0,94,303,115,147,659
8635,0,19,35,23,11,88
8636,0,1453,3750,1408,1901,8512
8637,0,94,303,115,147,659
8638,0,19,35,23,11,88
8639,0,24,32,9,17,82
8640,0,366,576,381,180,1503
8641,0,1644,2222,972,973,5811
8642,0,534,2514,1498,1057,5603
8643,0,1433,3715,1385,1890,8423
8644,0,94,303,115,147,659
8645,0,533,1924,650,976,4083
8646,0,24,32,9,17,82
8647,0,366,576,381,180,1503
8648,0,92,276,320,104,792
8649,556,237,294,184,100,815
8650,0,237,294,184,100,815
8651,0,92,276,320,104,792
8652,0,533,1924,650,976,4083
8653,0,1527,4018,1500,2038,9083
8654,0,24,32,9,17,82
8655,0,237,294,184,100,815
8656,0,92,276,320,104,792
8657,0,237,294,184,100,815
8658,0,92,276,320,104,792
8659,0,237,294,184,100,815
8660,0,92,276,320,104,792
8661,0,237,294,184,100,815
8662,0,92,276,320,104,792
8663,0,3538,4396,1705,2020,11659
8664,0,983,5097,2837,2218,11135
8665,0,1644,2222,972,973,5811
8666,0,534,2514,1498,1057,5603
8667,0,237,294,184,100,815
8668,0,92,276,320,104,792
8669,556,92,276,320,104,792
8670,0,237,294,184,100,815
8671,0,237,294,184,100,815
8672,0,92,276,320,104,792
8673,0,818,1535,614,693,3660
8674,0,92,276,320,104,792
8675,0,402,1686,762,726,3576
8676,0,365,983,1067,437,2852
8677,0,237,294,184,100,815
8678,0,575,755,523,241,2094
8679,0,608,1289,464,629,2990
8680,0,402,1686,762,726,3576
8681,0,282,722,752,357,2113
8682,0,575,755,523,241,2094
8683,0,1644,2222,972,973,5811
8684,0,534,2514,1498,1057,5603
8685,0,282,722,752,357,2113
8686,0,575,755,523,241,2094
8687,0,282,722,752,357,2113
8688,0,575,755,523,241,2094
8689,0,3538,4396,1705,2020,11659
8690,0,19,27,11,9,66
8691,0,11,64,31,20,126
8692,0,282,722,752,357,2113
8693,0,575,755,523,241,2094
8694,13836,983,5097,2837,2218,11135
8695,0,282,722,752,357,2113
8696,0,575,755,523,241,2094
8697,0,608,1289,464,629,2990
8698,0,402,1686,762,726,3576
8699,0,19,27,11,9,66
8700,0,11,64,31,20,126
8701,0,533,1924,650,976,4083
8702,0,1186,3475,1128,1875,7664
8703,0,1644,2222,972,973,5811
8704,0,534,2514,1498,1057,5603
8705,0,282,722,752,357,2113
8706,0,575,755,523,241,2094
8707,16671,3271,7350,2090,3986,16697
8708,17403,2036,8481,2707,4154,17378
8709,0,282,722,752,357,2113
8710,0,575,755,523,241,2094
8711,0,19,27,11,9,66
8712,0,11,64,31,20,126
8713,0,282,722,752,357,2113
8714,0,575,755,523,241,2094
8715,0,608,1289,464,629,2990
8716,0,402,1686,762,726,3576
8717,0,1644,2222,972,973,5811
8718,0,534,2514,1498,1057,5603
8719,0,1186,3475,1128,1875,7664
8720,0,533,1924,650,976,4083
8721,13836,3538,4396,1705,2020,11659
8722,0,282,722,752,357,2113
8723,0,23,107,41,39,210
8724,0,19,27,11,9,66
8725,0,11,64,31,20,126
8726,0,225,640,725,317,1907
8727,0,781,4565,2153,1941,9440
8728,0,1644,2222,972,973,5811
8729,0,274,1880,693,771,3618
8730,0,340,851,858,384,2433
8731,0,608,1289,464,629,2990
8732,0,402,1686,762,726,3576
8733,0,1082,1479,370,761,3692
8734,0,274,1880,693,771,3618
8735,0,642,959,656,309,2566
8736,0,340,851,858,384,2433
8737,0,19,27,11,9,66
8738,0,11,64,31,20,126
8739,0,3044,3831,1251,1858,9984
8740,0,533,1924,650,976,4083
8741,0,1082,1479,370,761,3692
8742,0,274,1880,693,771,3618
8743,0,1186,3475,1128,1875,7664
8744,0,608,1289,464,629,2990
8745,0,402,1686,762,726,3576
8746,0,3044,3831,1251,1858,9984
8747,0,76,204,204,92,576
8748,0,1082,1479,370,761,3692
8749,0,216,1720,499,699,3134
8750,0,781,4565,2153,1941,9440
8751,0,533,1924,650,976,4083
8752,0,608,1289,464,629,2990
8753,0,402,1686,762,726,3576
8754,0,1186,3475,1128,1875,7664
8755,0,608,1289,464,629,2990
8756,0,402,1686,762,726,3576
8757,0,533,1924,650,976,4083
8758,0,1186,3475,1128,1875,7664
8759,0,23,30,9,14,76
8760,0,0,0,0,0,0
8761,0,23,30,9,14,76
8762,0,0,0,0,0,0
8763,0,533,1924,650,976,4083
8764,0,1186,3475,1128,1875,7664
8765,0,3044,3831,1251,1858,9984
8766,0,0,0,0,0,0
8767,0,3044,3831,1251,1858,9984
8768,0,0,0,0,0,0
8769,0,0,0,0,0,0
8770,0,781,4565,2153,1941,9440
8771,0,0,0,0,0,0
8772,0,781,4565,2153,1941,9440
8773,0,608,1289,464,629,2990
8774,0,332,1447,684,587,3050
8775,0,27,42,9,25,103
8776,0,71,276,89,139,575
8777,0,533,1924,650,976,4083
8778,0,3044,3831,1251,1858,9984
8779,0,0,0,0,0,0
8780,0,1186,3475,1128,1875,7664
8781,0,0,0,0,0,0
8782,0,781,4565,2153,1941,9440
8783,0,23,30,9,14,76
8784,0,0,0,0,0,0
8785,0,2,9,6,4,21
8786,0,26,64,42,20,152
8787,0,26,64,42,20,152
8788,0,2,9,6,4,21
8789,0,2,9,6,4,21
8790,0,26,64,42,20,152
8791,0,363,892,891,395,2541
8792,0,642,959,656,309,2566
8793,0,2,9,6,4,21
8794,0,23,30,9,14,76
8795,0,0,0,0,0,0
8796,0,781,4565,2153,1941,9440
8797,0,3044,3831,1251,1858,9984
8798,0,27,46,10,26,109
8799,0,15,21,10,8,54
8800,0,534,1085,400,522,2541
8801,0,332,1447,684,587,3050
8802,0,27,46,10,26,109
8803,0,15,21,10,8,54
8804,0,781,4565,2153,1941,9440
8805,0,3017,3785,1241,1833,9876
8806,0,15,21,10,8,54
8807,0,19,27,11,9,66
8808,0,1,6,1,1,9
8809,0,10,58,29,19,116
8810,0,19,27,11,9,66
8811,0,1,41,11,1,54
8812,0,0,0,0,0,0
8813,0,0,36,10,0,46
8814,0,26,41,9,25,101
8815,0,0,1,0,0,1
8816,0,1,5,1,1,8
8817,0,0,36,10,0,46
8818,0,15,22,10,9,56
8819,0,1,41,11,1,54
8820,0,15,22,10,9,56
8821,0,15,22,10,9,56
8822,0,1,41,11,1,54
8823,0,4,40,12,0,56
8824,0,10,58,29,19,116
8825,0,4,40,12,0,56
8826,0,777,4525,2142,1940,9384
8827,0,3032,3806,1250,1842,9930
8828,0,534,1085,400,522,2541
8829,0,332,1447,684,587,3050
8830,0,4,40,12,0,56
8831,0,10,58,29,19,116
8832,0,3032,3806,1250,1842,9930
8833,0,787,4583,2171,1960,9501
8834,0,533,1924,650,976,4083
8835,0,1186,3475,1128,1875,7664
8836,3131,952,1307,232,717,3208
8837,0,216,1720,499,699,3134
8838,0,26,64,42,20,152
8839,0,2,9,6,4,21
8840,0,534,1085,400,522,2541
8841,0,332,1447,684,587,3050
8842,0,952,1307,232,717,3208
8843,0,216,1720,499,699,3134
8844,3131,216,1720,499,699,3134
8845,0,952,1307,232,717,3208
8846,0,26,64,42,20,152
8847,0,509,1869,615,959,3952
8848,0,1186,3475,1128,1875,7664
8849,0,534,1085,400,522,2541
8850,0,332,1447,684,587,3050
8851,0,3032,3806,1250,1842,9930
8852,0,787,4583,2171,1960,9501
8853,0,509,1869,615,959,3952
8854,0,1186,3475,1128,1875,7664
8855,0,51,141,171,54,417
8856,0,534,1085,400,522,2541
8857,0,300,1384,549,564,2797
8858,0,3032,3806,1250,1842,9930
8859,0,509,1869,615,959,3952
8860,0,1186,3475,1128,1875,7664
8861,0,787,4583,2171,1960,9501
8862,0,3032,3806,1250,1842,9930
8863,0,509,1869,615,959,3952
8864,0,787,4583,2171,1960,9501
8865,0,1186,3475,1128,1875,7664
8866,0,952,1307,232,717,3208
8867,0,216,1720,499,699,3134
8868,0,787,4583,2171,1960,9501
8869,0,952,1307,232,717,3208
8870,0,216,1720,499,699,3134
8871,0,3032,3806,1250,1842,9930
8872,0,787,4583,2171,1960,9501
8873,0,216,1720,499,699,3134
8874,0,952,1307,232,717,3208
8875,0,509,1869,615,959,3952
8876,0,1186,3475,1128,1875,7664
8877,0,456,991,327,495,2269
8878,0,300,1384,549,564,2797
8879,0,23,30,9,14,76
8880,0,0,0,0,0,0
8881,0,509,1869,615,959,3952
8882,0,1186,3475,1128,1875,7664
8883,0,3032,3806,1250,1842,9930
8884,0,787,4583,2171,1960,9501
8885,0,509,1869,615,959,3952
8886,0,1186,3475,1128,1875,7664
8887,0,456,991,327,495,2269
8888,0,300,1384,549,564,2797
8889,0,456,991,327,495,2269
8890,0,300,1384,549,564,2797
8891,0,151,366,386,171,1074
8892,0,3032,3806,1250,1842,9930
8893,0,787,4583,2171,1960,9501
8894,0,509,1869,615,959,3952
8895,0,1186,3475,1128,1875,7664
8896,0,23,30,9,14,76
8897,0,0,0,0,0,0
8898,0,2857,3813,1371,1906,9947
8899,0,787,4583,2171,1960,9501
8900,0,23,30,9,14,76
8901,0,0,0,0,0,0
8902,0,456,991,327,495,2269
8903,0,300,1384,549,564,2797
8904,0,2857,3813,1371,1906,9947
8905,0,2857,3813,1371,1906,9947
8906,0,787,4583,2171,1960,9501
8907,0,509,1869,615,959,3952
8908,0,1186,3475,1128,1875,7664
8909,0,787,4583,2171,1960,9501
8910,0,2857,3813,1371,1906,9947
8911,0,787,4583,2171,1960,9501
8912,0,2857,3813,1371,1906,9947
8913,0,787,4583,2171,1960,9501
8914,0,23,30,9,14,76
8915,0,0,0,0,0,0
8916,0,509,1869,615,959,3952
8917,0,1186,3475,1128,1875,7664
8918,0,71,276,89,139,575
8919,0,100,246,74,134,554
8920,0,787,4583,2171,1960,9501
8921,0,2857,3813,1371,1906,9947
8922,0,23,30,9,14,76
8923,0,0,0,0,0,0
8924,0,23,30,9,14,76
8925,0,107,303,360,141,911
8926,0,23,30,9,14,76
8927,0,680,4280,1811,1819,8590
8928,0,509,1869,615,959,3952
8929,0,0,0,0,0,0
8930,0,23,30,9,14,76
8931,0,1186,3475,1128,1875,7664
8932,0,0,0,0,0,0
8933,0,23,30,9,14,76
8934,0,456,991,327,495,2269
8935,0,300,1384,549,564,2797
8936,0,2773,3540,1020,1780,9113
8937,0,680,4280,1811,1819,8590
8938,0,23,30,9,14,76
8939,0,0,0,0,0,0
8940,0,509,1869,615,959,3952
8941,0,1186,3475,1128,1875,7664
8942,0,456,991,327,495,2269
8943,0,2773,3540,1020,1780,9113
8944,0,328,1400,552,572,2852
8945,0,95,133,126,59,413
8946,0,85,121,111,39,356
8947,10427,916,5577,2252,2342,11087
8948,0,509,1869,615,959,3952
8949,0,1186,3475,1128,1875,7664
8950,0,509,1869,615,959,3952
8951,0,1186,3475,1128,1875,7664
8952,10427,3171,4426,1240,2244,11081
8953,0,916,5577,2252,2342,11087
8954,0,299,803,834,360,2296
8955,0,3171,4426,1240,2244,11081
8956,0,13,119,34,47,213
8957,0,232,719,822,313,2086
8958,0,697,4977,1464,2075,9213
8959,0,509,1869,615,959,3952
8960,0,1186,3475,1128,1875,7664
8961,0,2627,3786,719,2073,9205
8962,0,697,4977,1464,2075,9213
8963,0,509,1869,615,959,3952
8964,0,1186,3475,1128,1875,7664
8965,0,509,1869,615,959,3952
8966,0,1186,3475,1128,1875,7664
8967,0,2627,3786,719,2073,9205
8968,0,697,4977,1464,2075,9213
8969,0,2627,3786,719,2073,9205
8970,0,697,4977,1464,2075,9213
8971,0,2627,3786,719,2073,9205
8972,0,697,4977,1464,2075,9213
8973,0,2627,3786,719,2073,9205
8974,0,0,0,0,0,0
8975,0,0,0,0,0,0
8976,0,697,4977,1464,2075,9213
8977,4513,509,1869,615,959,3952
8978,0,1186,3475,1128,1875,7664
8979,0,2627,3786,719,2073,9205
8980,0,697,4977,1464,2075,9213
8981,0,2627,3786,719,2073,9205
8982,0,697,4977,1464,2075,9213
8983,0,2627,3786,719,2073,9205
8984,0,0,0,0,0,0
8985,0,0,0,0,0,0
8986,0,697,4977,1464,2075,9213
8987,0,2627,3786,719,2073,9205
8988,0,697,4977,1464,2075,9213
8989,0,2627,3786,719,2073,9205
8990,0,0,0,0,0,0
8991,0,0,0,0,0,0
8992,0,697,4977,1464,2075,9213
8993,0,2627,3786,719,2073,9205
8994,0,697,4977,1464,2075,9213
8995,0,509,1869,615,959,3952
8996,4513,1186,3475,1128,1875,7664
8997,0,2627,3786,719,2073,9205
8998,0,697,4977,1464,2075,9213
8999,0,2627,3786,719,2073,9205
9000,0,697,4977,1464,2075,9213
9001,9210,697,4977,1464,2075,9213
9002,0,509,1869,615,959,3952
9003,0,1186,3475,1128,1875,7664
9004,0,2627,3786,719,2073,9205
9005,9210,2627,3786,719,2073,9205
9006,9210,697,4977,1464,2075,9213
9007,0,272,527,423,152,1374
9008,0,274,518,433,173,1398
5465,0,86,208,201,68,563
9009,0,0,0,0,0,0
9010,0,134,206,177,52,569
5087,0,193,316,239,108,856
9011,0,86,208,201,68,563
9012,0,272,527,423,152,1374
9013,0,274,518,433,173,1398
9014,0,272,527,423,152,1374
9015,0,272,527,423,152,1374
9016,0,274,518,433,173,1398
9017,0,0,0,0,0,0
9018,0,0,0,0,0,0
9019,0,70,136,124,42,372
9020,0,58,129,117,39,343
5211,0,58,129,117,39,343
9021,0,0,0,0,0,0
9022,0,70,136,124,42,372
9023,0,66,112,99,32,309
9024,0,86,249,290,56,681
9025,0,682,1111,965,451,3209
9026,0,105,239,222,89,655
9027,0,467,906,850,369,2592
4972,0,486,1016,903,394,2799
4363,0,396,551,452,293,1692
4417,0,81,146,102,40,369
4363,0,396,551,452,293,1692
4417,0,209,433,366,164,1172
4037,0,373,704,631,284,1992
9033,0,119,261,205,69,654
9034,0,251,499,405,223,1378
4074,0,337,747,695,280,2059
9035,0,66,112,99,32,309
9036,0,264,449,378,214,1305
9037,0,576,1414,1379,596,3965
9038,0,445,1022,811,313,2591
9039,0,1193,1619,1246,738,4796
5636,0,155,246,191,77,669
9017,0,55,91,99,49,294
5277,0,20,49,47,17,133
9043,0,671,1776,1824,802,5073
9044,0,1030,1367,950,478,3825
9045,0,333,424,323,133,1213
9046,0,6149,11218,7959,4937,30263
9047,0,2036,8481,2707,4154,17378
9048,16671,3271,7350,2090,3986,16697
9049,0,2846,12188,3870,5912,24816
9050,0,4627,9877,2721,5361,22586
9051,0,535,2512,784,1180,5011
9052,3877,932,1667,402,908,3909
9053,0,853,6656,1937,2717,12163
9054,12145,3614,4937,867,2708,12126
9055,0,507,1864,610,957,3938
9056,0,1186,3475,1128,1875,7664
9057,0,6564,12296,8836,5360,33056
9058,42386,6390,14489,10249,6347,37475
9059,0,6095,10640,7266,4731,28732
9060,0,471,941,730,330,2472
9061,0,485,1136,1002,306,2929
9062,0,4348,14079,6527,6743,31697
9063,0,3538,13817,5140,6968,29463
9064,28896,5111,10940,4713,5482,26246
9065,21917,5884,9625,6135,4249,25893
9066,0,3939,10313,7074,4281,25607
9067,0,4445,9244,7541,5189,26419
6910,0,875,1690,1027,500,4092
6905,0,582,1450,1260,491,3783
7252,0,173,442,452,180,1247
7296,0,227,497,480,192,1396
6905,0,615,1302,992,330,3239
6910,0,875,1690,1027,500,4092
0,0,64,109,80,26,279
4417,0,17,37,22,14,90
4363,0,344,722,658,283,2007
5240,0,311,423,308,156,1198
9017,0,36,118,114,27,295
5277,0,159,432,394,171,1156
